base.jewishcommunities.jewish_community_existence_period.from	base.jewishcommunities.jewish_community_existence_period.to
base.rivalries.rivalry.start_of_rivalry	base.rivalries.rivalry.end_of_rivalry
base.schemastaging.comedy_group_membership.from	base.schemastaging.comedy_group_membership.to
base.refugee.camp_security_provision.from	base.refugee.camp_security_provision.to
base.conservationaction.program_coordination.start	base.conservationaction.program_coordination.end
projects.project_participation.from_date	projects.project_participation.to_date
basketball.basketball_historical_coach_position.from	basketball.basketball_historical_coach_position.to
base.summarystatistics.production_period.start_date_time	base.summarystatistics.production_period.end_date_time
celebrities.substance_abuse_problem.start	celebrities.substance_abuse_problem.end
religion.religious_organization_leadership.start_date	religion.religious_organization_leadership.end_date
base.jewishpress.responsibility.from	base.jewishpress.responsibility.to
base.killers.serial_killing_period.period_start	base.killers.serial_killing_period.period_end
music.artist.active_start	music.artist.active_end
base.iceandfire.house_lordship.start_date	base.iceandfire.house_lordship.end_date
base.tatort.tatort_team.from	base.tatort.tatort_team.to
base.theosbornboysaregrowing.trip.from	base.theosbornboysaregrowing.trip.to
base.correctedassumptions.corrected_is_a_assumption.from	base.correctedassumptions.corrected_is_a_assumption.to
base.livemusic.concert_performance.start_date	base.livemusic.concert_performance.end_date
base.mladraft.library_system_tenure.from_date	base.mladraft.library_system_tenure.to_date
celebrities.sexual_orientation_phase.start	celebrities.sexual_orientation_phase.end
award.category_ceremony_relationship.from	award.category_ceremony_relationship.to
business.open_times.hour_start	business.open_times.hour_end
sports.pro_sports_played.career_start	sports.pro_sports_played.career_end
base.rugby.rugby_club_tenure.from_date	base.rugby.rugby_club_tenure.to_date
base.engineeringdraft.manufacturing_plant_production.from	base.engineeringdraft.manufacturing_plant_production.to
user.robinboast.default_domain.historical_period.start_date	user.robinboast.default_domain.historical_period.end_date
user.skud.nuclear_weapons.nuclear_test_series.start_date	user.skud.nuclear_weapons.nuclear_test_series.end_date
base.americancivilwar.ship_allegiance.from_date	base.americancivilwar.ship_allegiance.to_date
base.rollerderby.team_performance.from	base.rollerderby.team_performance.to
sports.sports_team_coach_tenure.from	sports.sports_team_coach_tenure.to
user.rcheramy.default_domain.mayor.start_date	user.rcheramy.default_domain.mayor.end_date
base.government2.legislative_position_held.from	base.government2.legislative_position_held.to
user.rcheramy.default_domain.event.start_date	user.rcheramy.default_domain.event.end_date
base.scottishclans.scottish_clan_status_period.from	base.scottishclans.scottish_clan_status_period.to
user.evening.default_domain.business_group_relationship.from	user.evening.default_domain.business_group_relationship.to
user.skud.boats.vessel_class_construction.from_date	user.skud.boats.vessel_class_construction.to_date
base.spabase.spa_operator_tenure.from	base.spabase.spa_operator_tenure.to
rail.rolling_stock_tenure.from_date	rail.rolling_stock_tenure.to_date
base.mystery.cryptid_expedition.start_date	base.mystery.cryptid_expedition.end_date
user.blackhound.pennsylvania_state_navy.service_period.from_date	user.blackhound.pennsylvania_state_navy.service_period.to_date
base.associationfootball.soccer_squad_position.from	base.associationfootball.soccer_squad_position.to
base.column.column_frequency_duration.from	base.column.column_frequency_duration.to
military.military_posting.from_date	military.military_posting.to_date
zoos.animal_captivity.from	zoos.animal_captivity.to
base.markets.financial_market_operator_tenure.from	base.markets.financial_market_operator_tenure.to
sports.sports_team_captain_tenure.from	sports.sports_team_captain_tenure.to
soccer.football_player_loan.from	soccer.football_player_loan.to
boxing.boxing_title_tenure.from	boxing.boxing_title_tenure.to
organization.organization_membership.from	organization.organization_membership.to
base.schemastaging.previous_name.from	base.schemastaging.previous_name.to
medicine.hospital_ownership.start_date	medicine.hospital_ownership.end_date
base.popstra.incarceration.start_date	base.popstra.incarceration.end_date
royalty.system_title_relationship.from_date	royalty.system_title_relationship.to_date
base.convictsydney.residence_period.from	base.convictsydney.residence_period.to
base.thoroughbredracing.horse_owner_relationship.start_date	base.thoroughbredracing.horse_owner_relationship.end_date
base.schemastaging.cricket_roster.from	base.schemastaging.cricket_roster.to
organization.organization_committee_membership.from	organization.organization_committee_membership.to
user.danm.default_domain.sexual_relationship.from	user.danm.default_domain.sexual_relationship.to
royalty.system_of_nobility.used_from_date	royalty.system_of_nobility.used_to_date
base.conservationaction.participation.start	base.conservationaction.participation.end
base.schemastaging.heya_wrestler_relationship.from	base.schemastaging.heya_wrestler_relationship.to
base.popstra.religion_choice.start_date	base.popstra.religion_choice.end_date
base.architecture2.building_tenancy.from	base.architecture2.building_tenancy.to
base.represent.agent_agency_relationship.from	base.represent.agent_agency_relationship.to
base.coinsdaily.coin_series.minted_from	base.coinsdaily.coin_series.minted_to
base.represent.agent_celebrity_representation.from	base.represent.agent_celebrity_representation.to
base.architecture2.architectural_structure_ownership.from	base.architecture2.architectural_structure_ownership.to
education.gender_enrollment.from	education.gender_enrollment.to
user.pvonstackelberg.Futures_Studies.event.start_date	user.pvonstackelberg.Futures_Studies.event.end_date
user.joehughes.default_domain.lifetime.earliest_start_date	user.joehughes.default_domain.lifetime.earliest_end_date
user.joehughes.default_domain.lifetime.latest_start_date	user.joehughes.default_domain.lifetime.latest_end_date
celebrities.romantic_relationship.start_date	celebrities.romantic_relationship.end_date
base.schemastaging.opera_production_venue_relationship.start_date	base.schemastaging.opera_production_venue_relationship.end_date
organization.organization_board_membership.from	organization.organization_board_membership.to
user.synedra.didwho.rehab.start_date	user.synedra.didwho.rehab.end_date
base.schemastaging.election_campaign_extra.start_date	base.schemastaging.election_campaign_extra.end_date
dataworld.mass_data_operation.started_operation	dataworld.mass_data_operation.ended_operation
user.sprocketonline.default_domain.bothy_maintenance_tenure.from	user.sprocketonline.default_domain.bothy_maintenance_tenure.to
base.sanfranciscoscene.san_francisco_scene_event.date_started	base.sanfranciscoscene.san_francisco_scene_event.date_ended
base.satelites.satellite_imagery.date_image_collection_started	base.satelites.satellite_imagery.date_image_collection_ended
skiing.yearly_snowfall.season_start	skiing.yearly_snowfall.season_end
base.mladraft.mla_location_tenure.from_date	base.mladraft.mla_location_tenure.to_date
base.popstra.dated.start_date	base.popstra.dated.end_date
broadcast.radio_affiliation_duration.from_date	broadcast.radio_affiliation_duration.to_date
user.brandon_macuser.default_domain.convention.start_date	user.brandon_macuser.default_domain.convention.end_date
architecture.ownership.start_date	architecture.ownership.end_date
rail.railway_gauge_relationship.from_date	rail.railway_gauge_relationship.to_date
broadcast.callsign_duration.from_date	broadcast.callsign_duration.to_date
government.legislative_session.date_began	government.legislative_session.date_ended
base.schemastaging.holiday_occurrence.start	base.schemastaging.holiday_occurrence.end
royalty.chivalric_order_membership.from	royalty.chivalric_order_membership.to
government.election_poll.poll_start_date	government.election_poll.poll_end_date
user.sterops.accessibility.available_accessible_equipment.weekday_availability_start	user.sterops.accessibility.available_accessible_equipment.weekday_availability_end
user.sterops.accessibility.available_accessible_equipment.weekend_availability_start	user.sterops.accessibility.available_accessible_equipment.weekend_availability_end
law.court_courthouse_relationship.from_date	law.court_courthouse_relationship.to_date
base.collectives.collective_membership.from	base.collectives.collective_membership.to
broadcast.tv_channel.from	broadcast.tv_channel.to
base.mapcentral.fgdc_lineage.time_period_start	base.mapcentral.fgdc_lineage.time_period_end
music.concert.start_date	music.concert.end_date
base.popstra.vacation_choice.start_date	base.popstra.vacation_choice.end_date
tv.regular_tv_appearance.from	tv.regular_tv_appearance.to
user.itteco.ga.scheme.item_cost.period_from	user.itteco.ga.scheme.item_cost.period_to
user.tadhg.tbooks.book_edition_reading_event.start_date	user.tadhg.tbooks.book_edition_reading_event.end_date
base.jewishcommunities.jewish_cemetery_use.from	base.jewishcommunities.jewish_cemetery_use.to
food.licensee_tenure.from	food.licensee_tenure.to
base.formula1.formula_1_team_member.from	base.formula1.formula_1_team_member.to
theater.theater_production_staff_gig.from	theater.theater_production_staff_gig.to
comic_strips.comic_strip_syndicate_duration.from	comic_strips.comic_strip_syndicate_duration.to
base.horseracing.racecourse_horse_race_dates.from_date	base.horseracing.racecourse_horse_race_dates.to_date
user.cip22.default_domain.group_exposition.start_date	user.cip22.default_domain.group_exposition.end_date
government.political_party_tenure.from	government.political_party_tenure.to
base.visleg.collaborative_participation.from	base.visleg.collaborative_participation.to
base.americancivilwar.battle.start_date	base.americancivilwar.battle.end_date
opera.opera_production_staff_gig.from	opera.opera_production_staff_gig.to
base.formula1.formula_1_season.start_date	base.formula1.formula_1_season.end_date
automotive.manufacturing_plant_model_relationship.from	automotive.manufacturing_plant_model_relationship.to
base.peleton.cycling_team_based_at.from	base.peleton.cycling_team_based_at.to
biology.breed_registration.from	biology.breed_registration.to
user.cheunger.mw_ping_pong.match.start_date	user.cheunger.mw_ping_pong.match.end_date
user.philg.default_domain.concert_tour.start_date	user.philg.default_domain.concert_tour.end_date
base.webvideo.internet_video_season.from	base.webvideo.internet_video_season.to
government.government_position_held.from	government.government_position_held.to
user.alexander.misc.dated_name.from	user.alexander.misc.dated_name.to
base.celeb.lived_with.start	base.celeb.lived_with.end
user.paulshanks.project_management.structural_consultant.from	user.paulshanks.project_management.structural_consultant.to
user.paulshanks.project_management.architectural_consultant.from	user.paulshanks.project_management.architectural_consultant.to
book.editorial_tenure.from	book.editorial_tenure.to
user.hirschch.academic_conferences.academic_conference_instance.start_date	user.hirschch.academic_conferences.academic_conference_instance.end_date
opera.opera_role.from	opera.opera_role.to
business.company_name_change.start_date	business.company_name_change.end_date
base.rollerderby.official_performance.from	base.rollerderby.official_performance.to
music.conducting_tenure.from	music.conducting_tenure.to
base.yalebase.comedy_group_membership.start	base.yalebase.comedy_group_membership.end
people.place_lived.start_date	people.place_lived.end_date
soccer.football_team_management_tenure.from	soccer.football_team_management_tenure.to
user.jfry.default_domain.agricultural_certification.certification_start_date	user.jfry.default_domain.agricultural_certification.certification_end_date
military.military_service.from_date	military.military_service.to_date
base.mapcentral.fgdc_time_period.beginning_date	base.mapcentral.fgdc_time_period.ending_date
education.academic_post.from	education.academic_post.to
cricket.cricket_umpire_panel_membership.start	cricket.cricket_umpire_panel_membership.end
user.jamie.default_domain.yacht_racing.commodore_tenure.start_date	user.jamie.default_domain.yacht_racing.commodore_tenure.end_date
base.lewisandclark.places_eastward.from	base.lewisandclark.places_eastward.to
business.company_product_relationship.from_date	business.company_product_relationship.to_date
broadcast.content.production_start	broadcast.content.production_end
user.yellowbkpk.default_domain.movie_showtime.start_date	user.yellowbkpk.default_domain.movie_showtime.end_date
base.schemastaging.education_board_school_relationship.from	base.schemastaging.education_board_school_relationship.to
base.sportssandbox.sports_team_roster.from	base.sportssandbox.sports_team_roster.to
base.cdnpolitics.parliamentary_session.date_began	base.cdnpolitics.parliamentary_session.date_ended
base.nationalbridgeinventory.bridge_maintenance_tenure.from	base.nationalbridgeinventory.bridge_maintenance_tenure.to
rail.railway_operator_relationship.from_date	rail.railway_operator_relationship.to_date
user.pak21.default_domain.pen_name_usage.start	user.pak21.default_domain.pen_name_usage.end
base.shelvedcancelledandunfinishedfilms.development_hell.began	base.shelvedcancelledandunfinishedfilms.development_hell.ended
user.joehughes.default_domain.item_with_lifetime.start_date	user.joehughes.default_domain.item_with_lifetime.end_date
measurement_unit.time_interval.start	measurement_unit.time_interval.end
user.g_null_device.default_domain.psychoanalytic_supervision.supervision_from	user.g_null_device.default_domain.psychoanalytic_supervision.supervision_to
royalty.system_rank_relationship.from_date	royalty.system_rank_relationship.to_date
royalty.monarch.from_date	royalty.monarch.to_date
education.education.start_date	education.education.end_date
base.government2.elected_government_positions_held.from	base.government2.elected_government_positions_held.to
base.schemastaging.coach_athlete_relationship.from	base.schemastaging.coach_athlete_relationship.to
base.coloniesandempire.colony.start	base.coloniesandempire.colony.end
base.thoroughbredracing.horse_trainer_relationship.start_date	base.thoroughbredracing.horse_trainer_relationship.end_date
tv.tv_series_season.from	tv.tv_series_season.to
spaceflight.space_mission.mission_start_date	spaceflight.space_mission.mission_end_date
base.unitednations.united_nations_body_head_tenure.from	base.unitednations.united_nations_body_head_tenure.to
book.publisher_imprint_tenure.from	book.publisher_imprint_tenure.to
base.popstra.legal_dispute.start_date	base.popstra.legal_dispute.end_date
base.retail.retail_inventory_line.from	base.retail.retail_inventory_line.to
base.column.column_periodical_duration.date_began	base.column.column_periodical_duration.date_ended
broadcast.tv_affiliation_duration.from_date	broadcast.tv_affiliation_duration.to_date
business.sponsorship.from	business.sponsorship.to
rail.locomotive_class_operator_relationship.from_date	rail.locomotive_class_operator_relationship.to_date
user.cheunger.sports_test.coaching_relationship.from	user.cheunger.sports_test.coaching_relationship.to
user.skud.embassies_and_consulates.ambassadorial_tenure.from_date	user.skud.embassies_and_consulates.ambassadorial_tenure.to_date
base.fight.sports_official_tenure.from_date	base.fight.sports_official_tenure.to_date
business.company_product_line_relationship.from_date	business.company_product_line_relationship.to_date
base.banned.exiled.from	base.banned.exiled.to
people.appointment_nomination.from	people.appointment_nomination.to
user.g_null_device.default_domain.psychoanalytic_relationship.psychoanalysis_started	user.g_null_device.default_domain.psychoanalytic_relationship.psychoanalysis_ended
tv.tv_program_writer_relationship.start_date	tv.tv_program_writer_relationship.end_date
base.schemastaging.military_unit_posting.from	base.schemastaging.military_unit_posting.to
base.testmatchspecial.test_match_special_commentary_relationship.start	base.testmatchspecial.test_match_special_commentary_relationship.end
location.administrative_division_capital_relationship.from	location.administrative_division_capital_relationship.to
user.moonhouse.default_domain.non_government_office_holder.from	user.moonhouse.default_domain.non_government_office_holder.to
base.numismatics.obverse_legend.from	base.numismatics.obverse_legend.to
base.column.column_syndicate_duration.from	base.column.column_syndicate_duration.to
user.collord.bicycle_model.frame_material.start_available_date	user.collord.bicycle_model.frame_material.end_available_date
religion.religious_leadership_jurisdiction_appointment.from	religion.religious_leadership_jurisdiction_appointment.to
base.playball.naming_information.from	base.playball.naming_information.to
base.lewisandclark.places_westward.from	base.lewisandclark.places_westward.to
user.deizel.default_domain.event.start_date_time	user.deizel.default_domain.event.end_date_time
baseball.baseball_historical_managerial_position.from	baseball.baseball_historical_managerial_position.to
base.popstra.paid_support.start_date	base.popstra.paid_support.end_date
base.musicfestival.artist_festival_relationship.from	base.musicfestival.artist_festival_relationship.to
soccer.football_player_stats.from	soccer.football_player_stats.to
royalty.system_order_relationship.from	royalty.system_order_relationship.to
royalty.noble_title_tenure.from_date	royalty.noble_title_tenure.to_date
user.zeusi.default_domain.athlete_team_relationship.from	user.zeusi.default_domain.athlete_team_relationship.to
internet.website_ownership.from	internet.website_ownership.to
user.micahsaul.advertising.ad_campaign.start_date	user.micahsaul.advertising.ad_campaign.end_date
base.iceandfire.house_weapon_stint.from	base.iceandfire.house_weapon_stint.to
base.cdnpolitics.lobbying_session.start_date	base.cdnpolitics.lobbying_session.end_date
base.feudalism.fief_ownership.from	base.feudalism.fief_ownership.to
freebase.apps.hosts.com.freebaseapps.glamourapartments.item_cost.period_from	freebase.apps.hosts.com.freebaseapps.glamourapartments.item_cost.period_to
base.skateboarding.brand_distribution_relationship.from	base.skateboarding.brand_distribution_relationship.to
book.place_of_publication_period.from	book.place_of_publication_period.to
government.legislative_committee_membership.start_date	government.legislative_committee_membership.end_date
user.patrick.default_domain.warship_crew_tenure.from	user.patrick.default_domain.warship_crew_tenure.to
user.akatenev.weapons.weapon.production_start_date	user.akatenev.weapons.weapon.production_end_date
amusement_parks.disney_ride_ticket_membership.from	amusement_parks.disney_ride_ticket_membership.to
base.schemastaging.theater_production_venue_relationship.start_date	base.schemastaging.theater_production_venue_relationship.end_date
tv.tv_network_duration.from	tv.tv_network_duration.to
base.brothels.prostitute_employment_tenure.from	base.brothels.prostitute_employment_tenure.to
rail.locomotive_ownership.from_date	rail.locomotive_ownership.to_date
astronomy.meteor_shower_occurrence.observation_start	astronomy.meteor_shower_occurrence.observation_ends
user.cheunger.tennis.tennis_team_membership.from	user.cheunger.tennis.tennis_team_membership.to
royalty.royal_line.ruled_from	royalty.royal_line.ruled_to
base.unitednations.united_nations_body_membership.from	base.unitednations.united_nations_body_membership.to
user.tpshek.default_domain.job.start_date	user.tpshek.default_domain.job.end_date
tv.tv_producer_term.from	tv.tv_producer_term.to
music.group_membership.start	music.group_membership.end
theater.theater_role.from	theater.theater_role.to
base.esports.e_sports_roster_position.from	base.esports.e_sports_roster_position.to
base.famouspets.pet_ownership.from	base.famouspets.pet_ownership.to
base.conservationaction.program_financial_support.start	base.conservationaction.program_financial_support.end
base.britishpubs.pub_owner_tenure.from	base.britishpubs.pub_owner_tenure.to
user.ndunham.default_domain.uol_author.start	user.ndunham.default_domain.uol_author.end
base.clinicaltrials.clinical_trials_sponsorship.from	base.clinicaltrials.clinical_trials_sponsorship.to
tv.tv_regular_personal_appearance.from	tv.tv_regular_personal_appearance.to
biology.animal_ownership.from	biology.animal_ownership.to
law.judicial_tenure.from_date	law.judicial_tenure.to_date
base.nuclearregulatorycommission.inspection_report.inspection_start_date	base.nuclearregulatorycommission.inspection_report.inspection_end_date
base.livemusic.concert.start_date	base.livemusic.concert.end_date
organization.leadership.from	organization.leadership.to
user.cheunger.sports_test.roster_membership.from	user.cheunger.sports_test.roster_membership.to
base.engineeringdraft.manufacturing_plant_operation.from	base.engineeringdraft.manufacturing_plant_operation.to
time.event.start_date	time.event.end_date
book.periodical_format_period.from	book.periodical_format_period.to
base.handball.handball_roster_position.from	base.handball.handball_roster_position.to
user.pvonstackelberg.Futures_Studies.issue.start_timeframe	user.pvonstackelberg.Futures_Studies.issue.end_timeframe
base.schemastaging.written_work_author_credit.from	base.schemastaging.written_work_author_credit.to
base.mediaextended.film_ranch_owner.from	base.mediaextended.film_ranch_owner.to
base.gender.personal_gender_identity.start_date	base.gender.personal_gender_identity.end_date
base.business_report.dated_financial_reporting_value.start_date	base.business_report.dated_financial_reporting_value.end_date
base.x2010fifaworldcupsouthafrica.tournament_date.from	base.x2010fifaworldcupsouthafrica.tournament_date.to
base.collectives.armed_force_alliance_tenure.from	base.collectives.armed_force_alliance_tenure.to
base.thebigpitch.promoted_product.from	base.thebigpitch.promoted_product.to
base.cars_refactor.plant_model_year_relationship.from	base.cars_refactor.plant_model_year_relationship.to
skiing.ski_area_ownership.start_date	skiing.ski_area_ownership.end_date
sports.team_venue_relationship.from	sports.team_venue_relationship.to
base.goodrelations.offer.valid_from	base.goodrelations.offer.valid_to
symbols.flag_use.from_date	symbols.flag_use.to_date
american_football.football_historical_coach_position.from	american_football.football_historical_coach_position.to
government.electoral_college_elected_office.from	government.electoral_college_elected_office.to
base.wrestling.championship_title_reign.from	base.wrestling.championship_title_reign.to
base.crime.chief_of_police_tenure.from_date	base.crime.chief_of_police_tenure.to_date
user.jfry.default_domain.community_supported_agriculture.season_start_date	user.jfry.default_domain.community_supported_agriculture.season_end_date
base.motorcycle.internet_forum_administration.start	base.motorcycle.internet_forum_administration.end
base.educationextended.residential_gender.from	base.educationextended.residential_gender.to
base.aubreymaturin.historical_event.start_date	base.aubreymaturin.historical_event.end_date
base.cars_refactor.company_make_relationship.from	base.cars_refactor.company_make_relationship.to
boats.ship_ownership.from_date	boats.ship_ownership.to_date
base.jewishcommunities.synagogue_use.from	base.jewishcommunities.synagogue_use.to
base.technologyofdoing.mission_statement.from	base.technologyofdoing.mission_statement.to
comic_strips.comic_strip_creator_duration.from	comic_strips.comic_strip_creator_duration.to
base.intellectualproperty.intellectual_property_owner.from_date	base.intellectualproperty.intellectual_property_owner.to_date
base.column.column_author_duration.from	base.column.column_author_duration.to
base.peleton.historical_cycling_roster_position.from	base.peleton.historical_cycling_roster_position.to
user.cheunger.sports_test.ranking.from	user.cheunger.sports_test.ranking.to
base.tallships.tall_ship_event_instance.start_date	base.tallships.tall_ship_event_instance.end_date
base.plaques.blue_plaque_dedication.from	base.plaques.blue_plaque_dedication.to
base.schemastaging.book_author_credit.from	base.schemastaging.book_author_credit.to
sports.sports_team_roster.from	sports.sports_team_roster.to
user.cheunger.sports_test.sports_team_membership.from	user.cheunger.sports_test.sports_team_membership.to
business.brand_slogan.from_date	business.brand_slogan.to_date
book.periodical_frequency.from	book.periodical_frequency.to
base.harvard.house_master_tenure.start_date	base.harvard.house_master_tenure.end_date
user.cheunger.sports_test.professional_athlete_career.from	user.cheunger.sports_test.professional_athlete_career.to
user.wouter.default_domain.roadblock.start_date	user.wouter.default_domain.roadblock.end_date
base.survivor.filming_dates.start	base.survivor.filming_dates.end
base.disaster2.state_of_emergency_declaration.from_date	base.disaster2.state_of_emergency_declaration.to_date
base.change.name_change.from	base.change.name_change.to
base.litcentral.sampling_campaign.date_sampling_started	base.litcentral.sampling_campaign.date_sampling_ended
base.engineering.engineering_project_phase.from	base.engineering.engineering_project_phase.to
organization.organization_relationship.from	organization.organization_relationship.to
user.robert.x2008_presidential_election.campaign.began_campaign	user.robert.x2008_presidential_election.campaign.ended_campaign
base.engineeringdraft.component_manufacturing.from	base.engineeringdraft.component_manufacturing.to
business.brand_colors.from_date	business.brand_colors.to_date
business.employment_tenure.from	business.employment_tenure.to
base.schemastaging.golfer_caddie_relationship.from	base.schemastaging.golfer_caddie_relationship.to
user.brendan.musician_products.product_model.production_start_date	user.brendan.musician_products.product_model.production_end_date
base.rollerderby.coach_performance.from	base.rollerderby.coach_performance.to
base.architecture2.architectural_structure_use_period.from	base.architecture2.architectural_structure_use_period.to
base.popstra.substance_abuse.start_date	base.popstra.substance_abuse.end_date
base.schemastaging.sumo_wrestler_rank_relationship.from	base.schemastaging.sumo_wrestler_rank_relationship.to
base.ultimate.ultimate_historical_roster_position.from	base.ultimate.ultimate_historical_roster_position.to
base.schemastaging.sumo_wrestler_division_relationship.from	base.schemastaging.sumo_wrestler_division_relationship.to
business.asset_ownership.from	business.asset_ownership.to
base.popstra.friendship.start_date	base.popstra.friendship.end_date
base.religiousjurisdiction.religious_leader_appointment.from	base.religiousjurisdiction.religious_leader_appointment.to
cricket.cricket_coach_tenure.start_date	cricket.cricket_coach_tenure.end_date
base.x2010fifaworldcupsouthafrica.world_cup_qualifying_round.matches_start_date	base.x2010fifaworldcupsouthafrica.world_cup_qualifying_round.matches_end_date
base.iceandfire.possession.from	base.iceandfire.possession.to
medicine.medical_trial.start_date	medicine.medical_trial.end_date
dining.restaurant_chef_association.from_date	dining.restaurant_chef_association.to_date
boats.warship_service_period.start_date	boats.warship_service_period.end_date
business.stock_ticker_symbol.start_date	business.stock_ticker_symbol.end_date
user.sandos.research.research_proj_involvement.start_time	user.sandos.research.research_proj_involvement.end_time
base.folklore.event_in_mythology.start_date	base.folklore.event_in_mythology.end_date
base.nightclubs.nightclub_residency.from	base.nightclubs.nightclub_residency.to
base.popstra.rehab_stay.start_date	base.popstra.rehab_stay.end_date
base.patienthealthrecord.phr_record.date_started	base.patienthealthrecord.phr_record.date_ended
rail.railway_type_relationship.from_date	rail.railway_type_relationship.to_date
people.group_membership.from	people.group_membership.to
base.dancegroups.dance_group_membership.period_start	base.dancegroups.dance_group_membership.period_end
base.summarystatistics.dated_location.start_date_time	base.summarystatistics.dated_location.end_date_time
base.prison.imprisonment.from	base.prison.imprisonment.to
visual_art.artwork_location_relationship.from	visual_art.artwork_location_relationship.to
user.digitalarchivist.default_domain.appointed_government_position_held.from	user.digitalarchivist.default_domain.appointed_government_position_held.to
base.schemastaging.team_training_ground_relationship.from	base.schemastaging.team_training_ground_relationship.to
user.moonhouse.default_domain.reference_rate.start_of_publication	user.moonhouse.default_domain.reference_rate.end_of_publication
book.periodical_publisher_period.from	book.periodical_publisher_period.to
military.military_post_use.from_date	military.military_post_use.to_date
royalty.chivalric_rank_precedence.from	royalty.chivalric_rank_precedence.to
base.hotelbooking.stay.start	base.hotelbooking.stay.end
base.schemastaging.sports_team_manager_tenure.from	base.schemastaging.sports_team_manager_tenure.to
user.robert.roman_empire.roman_emperor.from	user.robert.roman_empire.roman_emperor.to
base.convictsydney.governor.from	base.convictsydney.governor.to
user.casperone.finance.unit_of_currency.circulated_from	user.casperone.finance.unit_of_currency.circulated_to
film.film_festival_sponsorship.from	film.film_festival_sponsorship.to
sports.pro_athlete.career_start	sports.pro_athlete.career_end
base.campaigns.activist_campaign.start_date	base.campaigns.activist_campaign.end_date
business.product_endorsement.from	business.product_endorsement.to
user.jfry.testing_types.j_marriage.from	user.jfry.testing_types.j_marriage.to
base.rugby.rugby_coaching_tenure.from_date	base.rugby.rugby_coaching_tenure.to_date
business.company_brand_relationship.from_date	business.company_brand_relationship.to_date
base.iceandfire.marriage.from	base.iceandfire.marriage.to
base.popstra.support.start_date	base.popstra.support.end_date
base.popstra.lived_with.start_date	base.popstra.lived_with.end_date
medicine.manufactured_drug_form.marketing_start_date	medicine.manufactured_drug_form.marketing_end_date
sports.sports_official_tenure.from_date	sports.sports_official_tenure.to_date
base.aubreymaturin.crew_membership.from_date	base.aubreymaturin.crew_membership.to_date
base.americancomedy.comedy_group_membership.start_date	base.americancomedy.comedy_group_membership.end_date
baseball.historical_coaching_tenure.from	baseball.historical_coaching_tenure.to
fashion.designer_label_association.from_date	fashion.designer_label_association.to_date
user.pvonstackelberg.Futures_Studies.trend.start_timeframe	user.pvonstackelberg.Futures_Studies.trend.end_timeframe
base.convictsydney.building.construction_began	base.convictsydney.building.construction_ended
visual_art.art_period_movement.began_approximately	visual_art.art_period_movement.ended_approximately
religion.place_of_worship_historical_use.from_date	religion.place_of_worship_historical_use.to_date
people.marriage.from	people.marriage.to
base.services.special_hours.hour_start	base.services.special_hours.hour_end
base.summarystatistics.time_span.start_date_time	base.summarystatistics.time_span.end_date_time
user.jondblackburn.default_domain.journal_coverage.start_date	user.jondblackburn.default_domain.journal_coverage.end_date
architecture.occupancy.from	architecture.occupancy.to
user.g_null_device.default_domain.registration_of_psychoanalysis.psychoanalyst_registered_from	user.g_null_device.default_domain.registration_of_psychoanalysis.psychoanalyst_registered_to
base.americancivilwar.campaign.start_date	base.americancivilwar.campaign.end_date
