automotive.engine.engine_type	automotive.engine_type.used_in
biology.animal_breed.examples	biology.pedigreed_animal.breed
biology.organism_classification.child_classifications	biology.organism_classification_placement.higher_classification
business.product_category.products	business.consumer_product.category
computer.os_compatibility.computer	computer.computer.compatible_oses
engineering.battery.size	engineering.battery_size.batteries_of_this_size
medicine.compound_drug.compound_of	medicine.drug.part_of_compound_drug
medicine.diagnostic_test_signs.test	medicine.diagnostic_test.signs
military.military_unit_size.units_of_this_type	military.military_unit.unit_size
religion.place_of_worship_historical_use.religion	religion.religion.places_of_worship_historical
spaceflight.astronaut.space_agency	spaceflight.space_agency.astronauts
sports.golf_facility.access	sports.golf_club_access.golf_clubs
astronomy.galactic_group.galaxy_cluster	astronomy.galactic_cluster.galaxy_groups
business.business_operation.competitive_space	business.competitive_space_mediator.company
computer.software.developer	computer.software_developer.software
cvg.musical_game.input_method	cvg.input_method.games_using_this
fictional_universe.sibling_relationship_of_fictional_characters.siblings	fictional_universe.fictional_character.siblings
film.personal_film_appearance.film	film.film.personal_appearances
location.location.geometry	location.geometry.delineates_location
measurement_unit.heat_capacity_unit.measurement_system	measurement_unit.measurement_system.heat_capacity_units
medicine.medical_specialty.diseases_treated	medicine.disease.medical_specialties
organization.organization.advisors	business.company_advisor.companies_advised
symbols.coat_of_arms.supporter	symbols.heraldic_supporter.coat_of_arms
visual_art.art_period_movement.associated_artists	visual_art.visual_artist.associated_periods_or_movements
aviation.aircraft_ownership_count.aircraft_owner	aviation.aircraft_owner.aircraft_fleet_composition
cvg.game_version.developer	cvg.cvg_developer.game_versions_developed
film.film_song_relationship.composition	film.film_song.films
olympics.olympic_games.demonstration_events	olympics.olympic_event.contested_as_demonstration_event
religion.religious_organization.leaders	religion.religious_organization_leadership.organization
royalty.precedence.higher_rank	royalty.noble_rank.lower_rank
automotive.model.generations	automotive.generation.models
award.award_announcement.award	award.award.award_announcements
award.award_category.disciplines_or_subjects	award.award_discipline.awards_in_this_discipline
biology.gene_ontology_group.broader_group	biology.gene_ontology_group.narrower_group
law.us_patent.us_patent_type	law.us_patent_type.patents
medicine.drug_formulation.active_moieties	medicine.drug.active_moiety_of
music.music_video_gig.music_video	music.music_video.crew
music.recording.genre	music.genre.recordings
organization.leadership.person	business.board_member.leader_of
protected_sites.protected_site.governing_body	protected_sites.governing_body_of_protected_sites.protected_sites_governed
sports.sports_league.sport	sports.sport.leagues
sports.sports_team_coach.sports_coached	sports.sport.team_coaches
book.illustrator.books_illustrated	book.book.interior_illustrations_by
boxing.match_boxer_relationship.boxer	sports.boxer.matches
business.brand.parent_brand	business.brand.includes_brands
comic_books.comic_book_issue.cover_letters	comic_books.comic_book_letterer.comic_covers_lettered
engineering.engine_category.sub_categories	engineering.engine_category.category_of
film.performance.character	film.film_character.portrayed_in_films
media_common.literary_genre.stories_in_this_genre	book.short_story.genre
medicine.disease.treatments	medicine.medical_treatment.used_to_treat
medicine.drug_formulation.active_ingredient_moieties	medicine.drug_ingredient.active_moiety_of_formulation
projects.project.project_focus	projects.project_focus.projects
book.publishing_company.publisher	book.publisher_imprint_tenure.imprints
boxing.boxing_match.weight_class	sports.boxing_weight_division.matches
film.film.rating	film.content_rating.film
food.licensee_tenure.licensee	food.licensee.drinking_establishments
government.election.district	government.political_district.elections
military.casualties.combatant	military.military_combatant.casualties
olympics.olympic_bidding_city.olympics_bid_on	olympics.olympic_city_bid.bidding_city
rail.railway.operator_s	rail.railway_operator_relationship.railway
royalty.chivalric_rank.opposite_gender_equivalent	royalty.chivalric_rank_gender_equivalence.rank
soccer.football_league.governing_body	soccer.fifa.leagues_governed
automotive.model.successor	automotive.model.predecessor
education.academic_post.person	education.academic.appointments_fellowships_etc
finance.exchange_operator.exchanges_operated	finance.exchange_operator_relationship.exchange_operator
food.dish.ingredients	food.ingredient.dishes
music.music_video_performance.music_video_character	music.music_video_character.portrayed_in_music_videos
music.music_video_performance.special_music_video_performance_type	music.special_music_video_performance_type.special_music_video_performances
organization.organization_partnership.members	organization.organization.partnerships
religion.religious_leadership_jurisdiction.title	religion.religious_leadership_jurisdiction_appointment.jurisdiction
american_football.football_game.home_team	american_football.football_team.home_games
astronomy.orbital_relationship.orbit_type	astronomy.orbit_type.orbiting_bodies
celebrities.sexual_orientation_phase.sexual_orientation	celebrities.sexual_orientation.celebrities
engineering.power_plug_standard_type.compatible_power_systems	engineering.mains_power.compatible_plugs
measurement_unit.distance_unit.measurement_system	measurement_unit.measurement_system.length_units
media_common.dedication.dedicated_to	media_common.dedicatee.dedications
medicine.manufactured_drug_form.fda_otc_part	medicine.fda_otc_monograph_part.drugs_regulated
sports.sports_award.award	sports.sports_award_type.winners
award.award_category.presenting_organization	award.award_presenting_organization.award_categories_presented
comedy.comedy_group.genres	comedy.comedy_genre.groups
computer.programming_language.parent_language	computer.programming_language.dialects
conferences.conference.venue	conferences.conference_venue.conferences
fictional_universe.fictional_character.character_created_by	fictional_universe.fictional_character_creator.fictional_characters_created
geography.mountain.first_ascenders	geography.mountaineer.first_ascents
music.compositional_form.superforms	music.compositional_form.subforms
royalty.chivalric_order_membership.presented_by	royalty.chivalric_order_officer.memberships_presented
sports.sports_award.season	sports.sports_league_season.awards
amusement_parks.ride.area	amusement_parks.amusement_park_area.rides
astronomy.galaxy.galactic_group	astronomy.galactic_group.galaxies_in_group
astronomy.star_system.stars	astronomy.star.star_system
award.award_nomination.nominated_for	award.award_nominated_work.award_nominations
comic_books.comic_book_story.pencils	comic_books.comic_book_penciler.comic_books_penciled
language.conlang_purpose.languages_of_this_type	language.conlang.conlang_type
law.constitution.constitutional_convention	law.constitutional_convention.constitution
opera.opera_designer_gig.design_role	opera.opera_designer_role.designers
sports.golf_course.designer	sports.golf_course_designer.golf_courses
theater.theater_production_staff_gig.play	theater.theater_production.production_staff
american_football.football_team.conference	american_football.football_conference.teams
architecture.building.occupant	architecture.occupancy.building
chemistry.chemical_classification.chemicals_of_this_type	chemistry.chemical_compound.classifications
cricket.cricket_umpire_panel_membership.panel	cricket.cricket_umpire_panel.members
fashion.textile.fiber	fashion.fiber.textiles_made_from_this_fiber
fictional_universe.fictional_character.parents	fictional_universe.fictional_character.children
measurement_unit.thermal_conductivity_unit.measurement_system	measurement_unit.measurement_system.thermal_conductivity_units
opera.opera_production.opera	opera.opera.productions
projects.project_participation.participant	projects.project_participant.projects
royalty.order_of_chivalry.founders	royalty.chivalric_order_founder.orders_founded
tv.tv_network_duration.program	tv.tv_program.original_network
astronomy.telescope_type.higher_classification	astronomy.telescope_type.lower_telescope_classification
business.asset_ownership.owned_asset	business.asset.owners
education.educational_institution.school_magazines	education.school_magazine.school
engineering.battery_size.shape_format	engineering.battery_shape_format.battery_sizes
event.disaster.surviving_structures	event.disaster_affected_structure.survived_disasters
visual_art.artwork.artist	visual_art.visual_artist.artworks
cvg.computer_videogame.peripheral_classes_supported	computer.computer_peripheral_class.supporting_games
distilled_spirits.infused_spirit.producer	distilled_spirits.spirit_blender.infusions
location.metropolitan_area.anchor_city	location.metropolitan_area_anchor.metropolitan_area
medicine.drug_formulation.dosage_form	medicine.drug_dosage_form.formulations_available_in_this_form
medicine.medical_trial.phase	medicine.medical_trial_phase.medical_trials
music.recording.artist	music.artist.track
symbols.coat_of_arms.coronet	symbols.heraldic_coronet.coat_of_arms
tv.tv_producer_episode_credit.producer	tv.tv_producer.tv_episodes_produced
atom.feed_item.feed	atom.feed.items
business.trade_union.professions_represented	people.profession.represented_by_trade_unions
exhibitions.exhibition.exhibits	exhibitions.exhibit.exhibitions_displayed_in
food.food.nutrients	food.nutrition_fact.food
law.constitutional_amendment.constitution	law.constitution.amendments
media_common.quotation.spoken_by_character	fictional_universe.fictional_character.quotations
medicine.hospital.medical_specialties	medicine.medical_specialty.hospitals_with_this_specialty
metropolitan_transit.transit_system.transit_lines	metropolitan_transit.transit_line.transit_system
music.composition.composer	music.composer.compositions
olympics.olympic_athlete_affiliation.olympics	olympics.olympic_games.athletes
people.family.members	people.family_member.family
tv.tv_crewmember.tv_episodes_crewed	tv.tv_crew_gig.crewmember
architecture.light_attributes.light_type	architecture.light_characteristic.lighthouse_having_characteristics
astronomy.star_system.dwarf_planets	astronomy.dwarf_planet.star_system
automotive.trim_level.options	automotive.opt_trim_relationship.trim_levels
location.partial_containment_relationship.partially_contains	location.location.partially_contained_by
measurement_unit.specific_energy_unit.measurement_system	measurement_unit.measurement_system.specific_energy_units
measurement_unit.surface_tension_unit.measurement_system	measurement_unit.measurement_system.surface_tension_units
music.engineer.releases_engineered	music.release.engineers
protected_sites.protected_site.system	protected_sites.park_system.member_parks
royalty.order_of_chivalry.higher_order	royalty.chivalric_order_relationship.lower_order
soccer.football_disciplinary_action.player	soccer.football_player.disciplinary_action
visual_art.artwork_owner_relationship.artwork	visual_art.artwork.owners
fictional_universe.fictional_character.medical_conditions	fictional_universe.medical_condition_in_fiction.characters_with_this_condition
geography.body_of_water.bridges	transportation.bridge.body_of_water_spanned
medicine.routed_drug.canonical_brands	medicine.drug_brand.canonical_routed_drugs
olympics.olympic_demonstration_competition.medalists	olympics.olympic_demonstration_medal_honor.event
spaceflight.space_program.missions	spaceflight.space_mission.space_program
time.month.calendar_system	time.calendar.months
wine.wine.wine_producer	wine.wine_producer.wines
biology.animal_breed.breed_of	biology.domesticated_animal.breeds
book.book_edition.publisher	book.publishing_company.books_published
broadcast.tv_affiliation_duration.network	tv.tv_network.affiliates
cricket.cricket_roster.extras	cricket.cricket_roster_extras.roster
engineering.engine.designer	engineering.engine_designer.engines_designed
food.drinking_establishment.licensee	food.licensee_tenure.drinking_establishment
music.recording_cluster.recordings	music.recording.recording_cluster
royalty.noble_title_tenure.noble_person	royalty.noble_person.titles
business.issuer.issue	business.issue.issuer
fictional_universe.fictional_calendar_system.directionality	fictional_universe.calendar_system_directionality.calendars
music.arrangement.arrangement_of	music.composition.arrangements
music.composition.recorded_as_album	music.album.compositions
physics.particle.family	physics.particle_family.particles
symbols.coat_of_arms.compartments	symbols.heraldic_compartment.coat_of_arms
tennis.tennis_player.tennis_grip	tennis.tennis_grip_style.tennis_players
aviation.airline_airport_presence.airline	aviation.airline.airports_served
computer.computer_processor.processor_family	computer.computer_processor.variants
music.concert_tour.artist	music.artist.concert_tours
organization.organization.organization_type	organization.organization_type.organizations_of_this_type
organization.organization_merger.became_organization	organization.organization.product_of_merger
transportation.road_junction.road	transportation.road.major_junctions
tv.tv_series_season.series	tv.tv_program.seasons
amusement_parks.roller_coaster.material	amusement_parks.roller_coaster_material.roller_coasters
biology.gene_ontology_group.part_group	biology.gene_ontology_group.aggregate_group
business.acquisition.acquiring_company	organization.organization.companies_acquired
engineering.power_plug_standard.plug_type	engineering.power_plug_standard_type.plug_standards
government.legislative_session.legislature	government.governmental_body.sessions
language.language_writing_system.type_of_writing	language.language_writing_type.writing_systems
measurement_unit.fuel_economy_unit.measurement_system	measurement_unit.measurement_system.fuel_economy_units
meteorology.tropical_cyclone_category.meteorological_service	meteorology.meteorological_service.tropical_cyclone_categories
organization.organization.committees	organization.organization_committee.committee_of
people.sibling_relationship.sibling	people.person.sibling_s
radio.radio_program.episodes	radio.radio_program_episode.program
sports.sports_league_draft_pick.team	sports.professional_sports_team.draft_picks
sports.sports_position.sport	sports.sport.positions
transportation.road.highway_system	transportation.highway_system.highways
business.brand.owner_s	business.company_brand_relationship.brand
celebrities.rehab.rehab_facility	celebrities.rehab_facility.celebrity_patients
comic_books.comic_book_issue.characters_on_cover	comic_books.comic_book_character.cover_appearances
comic_books.comic_book_story.script	comic_books.comic_book_writer.comic_books_written
dining.cuisine.restaurant	dining.restaurant.cuisine
film.performance.actor	film.actor.film
food.ingredient.compatible_with_dietary_restrictions	food.dietary_restriction.compatible_ingredients
location.location.contains	location.location.containedby
military.armed_force.sub_divisions	military.armed_force.sub_division_of
biology.animal_owner.animals_owned	biology.animal_ownership.owners
event.disaster.type_of_disaster	event.disaster_type.disasters_of_this_type
film.content_rating.film_rating_system	film.content_rating_system.film_ratings
law.us_patent.patent_office	law.patent_office.patents
music.music_video_gig.crewmember	music.music_video_crewmember.music_video_productions_crewed
projects.project.participants	projects.project_participation.project
time.holiday.holiday_period	time.holiday_period.holidays
basketball.basketball_historical_coach_position.coach	basketball.basketball_coach.previous_teams
bicycles.bicycle_model.bicycle_type	bicycles.bicycle_type.bicycle_models_of_this_type
business.product_category.product_lines	business.product_line.category
dataworld.information_source.provider	dataworld.data_provider.datasets_provided
engineering.signal_modulation_mode.parent_modulation	engineering.signal_modulation_mode.child_modulation
fictional_universe.event_in_fiction.location	fictional_universe.fictional_setting.events
fictional_universe.fictional_language.found_in_fictional_universe	fictional_universe.fictional_universe.languages
government.government_position_held.basic_title	government.government_office_category.officeholders
measurement_unit.irradiance_unit.measurement_system	measurement_unit.measurement_system.irradiance_units
measurement_unit.molar_energy_unit.measurement_system	measurement_unit.measurement_system.molar_energy_units
metropolitan_transit.transit_line.alternate_lines	metropolitan_transit.transit_line.primary_line
music.release_track.release	music.release.track_list
soccer.football_team_management_tenure.manager	soccer.football_team_manager.team
tv.tv_soundtrack.tv_program	tv.tv_program.soundtrack
tv.tv_subject.tv_episodes	tv.tv_series_episode.subjects
architecture.structure.architectural_style	architecture.architectural_style.examples
biology.gene_group_membership.group	biology.gene_group.gene
film.film.other_crew	film.film_crew_gig.film
film.film.produced_by	film.producer.film
internet.website_ownership.owner	internet.website_owner.websites_owned_new
medicine.infectious_disease.vaccine	medicine.vaccine.infectious_disease
medicine.manufactured_drug_form.shape	medicine.drug_form_shape.drugs_with_this_shape
medicine.medical_trial.design	medicine.medical_trial_design.trials
metropolitan_transit.transit_agency.systems	metropolitan_transit.transit_system.agency
music.concert_tour.tour_manager	music.tour_manager.tours_managed
soccer.football_player_transfer.purchasing_team	soccer.football_team.purchased_players
spaceflight.space_program.sponsor	spaceflight.space_program_sponsor.space_programs_sponsored
sports.sports_team_roster.team	sports.sports_team.roster
astronomy.galaxy_classification_code.galaxy_shape	astronomy.galactic_shape.galaxies_of_this_shape
book.poem.characters	book.poem_character.appears_in_poems
comic_books.comic_book_character.primary_universe	comic_books.comic_book_fictional_universe.characters_primarily_appearing_in_this_universe
computer.computer_emulator.peripheral_classes	computer.computer_peripheral_class.emulators
government.legislative_committee_membership.title	government.legislative_committee_title.held_by
measurement_unit.acceleration_unit.measurement_system	measurement_unit.measurement_system.acceleration_units
medicine.drug_brand.canonical_drug	medicine.drug.canonical_brands
tv.video.service	tv.video_host.videos
architecture.ownership.structure	architecture.structure.owner
automotive.manufacturing_plant_model_relationship.model	automotive.model.manufactured_at
automotive.trim_level.driveline	automotive.driveline.trim_levels
law.us_patent.assignee	law.patent_assignee.patents_assigned
location.location.coterminous_with	location.cotermination.location
location.offical_symbol_variety.symbols_of_this_kind	location.location_symbol_relationship.Kind_of_symbol
organization.organization.spun_off_from	organization.organization_spin_off.child_company
tv.regular_tv_appearance.seasons	tv.tv_series_season.regular_cast
book.short_non_fiction.mode_of_writing	book.short_non_fiction_variety.works
engineering.material.subclass	engineering.material.parent_material_class
food.ingredient.more_general_ingredient	food.ingredient.more_specific_ingredient
games.playing_card_game.play_direction	games.playing_card_game_play_direction.card_games
medicine.cancer_center.cancer_center_type	medicine.cancer_center_type.centers_of_this_kind
opera.opera_production.performed_at	opera.opera_house.productions
protected_sites.natural_or_cultural_site_listing.designation	protected_sites.natural_or_cultural_site_designation.sites
soccer.football_goal.match	soccer.football_match.goals
soccer.football_team_manager_match_participation.match	soccer.football_match.managers
symbols.coat_of_arms.ordinaire	symbols.heraldic_ordinaire_color.coat_of_arms
tv.sequence_of_tv_episode_segments.tv_series	tv.tv_program.recurring_segments
biology.fossil_specimen.organism	biology.organism_classification.fossil_specimens
book.author.book_editions_published	book.book_edition.author_editor
computer.computer.processor	computer.computer_processor.used_in_computers
fictional_universe.fictional_object.featured_in_fictional_universe	fictional_universe.fictional_universe.fictional_objects
fictional_universe.fictional_organization.appears_in_universes	fictional_universe.fictional_universe.organizations
government.legislative_committee.subcommittees	government.legislative_committee.subcommittee_of
martial_arts.martial_arts_certification.person	martial_arts.martial_artist.certifications
olympics.olympic_games.competitions	olympics.olympic_event_competition.olympic_games_contested
religion.religious_leadership_jurisdiction.organisation	religion.religious_organization.jurisdictions
spaceflight.astronaut.missions	spaceflight.space_mission.astronauts
symbols.coat_of_arms.torse	symbols.heraldic_torse.coat_of_arms
tv.tv_regular_personal_appearance.seasons	tv.tv_series_season.regular_personal_appearances
tv.tv_song.episode_segments	tv.tv_segment_song_relationship.song
award.award_achievement_level.higher_level	award.award_achievement_level.lower_level
comic_books.comic_book_story.letters	comic_books.comic_book_letterer.comic_stories_lettered
cvg.computer_videogame.designers	cvg.cvg_designer.games_designed
cvg.game_version.peripherals_supported	computer.computer_peripheral.supporting_game_versions
games.game.derivative_games	games.game.derived_from
law.legal_case.judges	law.judge.cases
location.administrative_division.country	location.country.administrative_divisions
location.partial_containment_relationship.partially_contained_by	location.location.partiallycontains
religion.religious_leadership_title.rank_or_role	religion.religious_leadership_role.religious_titles
soccer.football_league.league_system	soccer.football_league_system.leagues
tv.tv_program.spin_offs	tv.tv_program.spun_off_from
business.product_line.producer_s	business.company_product_line_relationship.product_line
exhibitions.exhibition_run.exhibition	exhibitions.exhibition.venues
film.film.cinematography	film.cinematographer.film
government.election.general_election	government.general_election.contests
rail.railway.gauge	rail.railway_gauge_relationship.railway
sports.professional_sports_team.owner_s	sports.sports_team_owner.teams_owned
tennis.tennis_tournament_championship.tournament	tennis.tennis_tournament.champions
travel.transportation.transport_terminus	travel.transport_terminus.travel_destinations_served
tv.tv_guest_personal_appearance.appearance_type	tv.non_character_role.tv_guest_personal_appearances
tv.tv_producer_term.producer	tv.tv_producer.programs_produced
astronomy.asteroid.spectral_type	astronomy.asteroid_spectral_type.asteroids_of_this_type
astronomy.extraterrestrial_location.type_of_planetographic_feature	astronomy.type_of_planetographic_feature.planetographic_features_of_this_type
book.poem.verse_form	book.poetic_verse_form.poems_of_this_form
military.military_combatant_group.conflict	military.military_conflict.combatants
tv.tv_guest_role.episodes_appeared_in	tv.tv_series_episode.guest_stars
architecture.lighthouse.construction	architecture.lighthouse_construction_material.used_on_lighthouse
aviation.aircraft_model.aircraft_type	aviation.aircraft_type.aircraft_of_this_type
boats.ship.owners	boats.ship_ownership.ship
cricket.cricket_coach.overall_odi_stats	cricket.cricket_team_stats.odi_coach
fictional_universe.character_species.found_in_fictional_universe	fictional_universe.fictional_universe.species
medicine.manufactured_drug_form.label_sections	medicine.drug_label_section.subject_drug
music.composition.lyricist	music.lyricist.lyrics_written
music.release.label	music.record_label.releases
olympics.olympic_participating_country.demonstration_medals_won	olympics.olympic_demonstration_medal_honor.country
physics.subatomic_particle_composition.particle	physics.quark.composes
sports.sports_award.award_winner	sports.sports_award_winner.awards
aviation.airport.airport_type	aviation.airport_type.airports_of_this_type
education.academic_post.institution	education.academic_institution.visiting_scholars_fellows_etc
event.speech_or_presentation.speech_topic	event.speech_topic.speeches_or_presentations_on_this_topic
exhibitions.exhibition_run.venue	exhibitions.exhibition_venue.exhibitions_at_this_venue
opera.opera_role.performer	music.opera_singer.opera_roles
opera.opera_role.role	opera.opera_character.portrayed_by
rail.locomotive.owners	rail.locomotive_ownership.locomotive
spaceflight.rocket_stage.fuel	spaceflight.rocket_fuel.rocket_stages
tv.tv_series_episode.writer	tv.tv_writer.episodes_written
visual_art.art_series.subject	visual_art.art_subject.art_series_on_the_subject
automotive.similar_automobile_models.related_model	automotive.model.related_models
biology.organism_classification.parent_classifications	biology.organism_classification_placement.lower_classification
business.holding.issue	business.issue.holders
comic_books.comic_story_printing.story	comic_books.comic_book_story.appeared_in
games.game.genre	games.game_genre.boardgames
military.military_post_use.military_post	military.military_post.used_by_armed_forces
military.military_posting.person	military.military_person.postings
theater.theater_production.producer	theater.theater_producer.plays_produced
travel.travel_destination.guidebooks	travel.guidebook.travel_destinations_covered
american_football.football_game.passing	american_football.game_passing_statistics.game
award.award_judging_term.award	award.award_category.judges_jury
book.editorial_tenure.editor	book.periodical_editor.periodicals_edited
exhibitions.exhibition_subject.exhibitions_created_about_this_subject	exhibitions.exhibition.subjects
film.film_festival.individual_festivals	film.film_festival_event.festival
physics.particle_family.parent_class	physics.particle_family.subclasses
soccer.football_goal.scorer	soccer.football_player.goals_scored
american_football.football_player.position_s	american_football.football_position.players
award.award_nomination.ceremony	award.award_ceremony.nominees
law.us_patent.inventor	law.inventor.us_patents
martial_arts.martial_artist.instructor	martial_arts.martial_artist.martial_arts_students
music.composition.subjects	book.book_subject.musical_compositions_about_this_topic
venture_capital.venture_investment.company	venture_capital.venture_funded_company.venture_investors
architecture.architect.architectural_style	architecture.architectural_style.architects
business.product_endorsement.product	business.endorsed_product.endorsements
comic_books.comic_book_series.featured_characters	comic_books.comic_book_character.regular_featured_appearances
comic_books.comic_book_series.publisher	comic_books.comic_book_publisher.comic_book_series_published
computer.file_format.extended_to	computer.file_format.extended_from
fictional_universe.fictional_universe.characters	fictional_universe.fictional_character.appears_in_these_fictional_universes
food.beer.brewery_brand	food.brewery_brand_of_beer.beers_produced
ice_hockey.hockey_player.hockey_position	ice_hockey.hockey_position.players
library.public_library.library_system	library.public_library_system.branches
organization.organization_membership.member	organization.organization_member.member_of
sports.multi_event_tournament.participating_countries	sports.sport_country.multi_event_tournaments_participated_in
architecture.museum.director	architecture.museum_director.museum
architecture.ownership.owner	architecture.architectural_structure_owner.structures_owned
astronomy.galaxy.galaxy_classification_hubble	astronomy.galaxy_classification_code.galaxies_of_this_code
film.film.sequel	film.film.prequel
medicine.vaccine.developed_by	medicine.vaccine_developer.vaccine
tv.tv_character.appeared_in_tv_episode_segments	tv.tv_segment_performance.character
astronomy.star_system.planetary_system	astronomy.star_system_body.star_system
business.sponsor.sponsorship	business.sponsorship.sponsored_by
education.educational_institution.mascot	education.school_mascot.school
government.us_president.vice_president	government.us_vice_president.to_president
medicine.drug_formulation.drug_category	medicine.drug_formulation_category.drug_formulations
medicine.drug_ingredient.more_general_ingredient	medicine.drug_ingredient.more_specific_ingredient
military.military_post_use.armed_force	military.armed_force.military_posts
tv.tv_subject.tv_programs	tv.tv_program.subjects
aviation.aircraft_manufacturer.aircraft_models_made	aviation.aircraft_model.manufacturer
biology.hybrid.parent_classifications	biology.hybrid_parentage.hybrid
film.film.directed_by	film.director.film
military.casualties.type_of_casualties	military.casualties_type.conflicts
music.album.genre	music.genre.albums
people.person.parents	people.person.children
people.place_lived.person	people.person.places_lived
spaceflight.rocket.launch_sites	spaceflight.rocket_launch_site.rockets_launched_here
tv.tv_segment_personal_appearance.appearance_type	tv.non_character_role.episode_segment_appearances
comic_books.comic_book_story.genre	comic_books.comic_book_genre.stories_in_this_genre
government.government_service.providing_agency	government.government_agency.provides_service
medicine.routed_drug.route_of_administration	medicine.drug_administration_route.route_of
visual_art.artwork.media	visual_art.visual_art_medium.artworks
aviation.airliner_accident.aircraft_type	aviation.aircraft_model.accidents
fictional_universe.fictional_character.species	fictional_universe.character_species.characters_of_this_species
location.country.second_level_divisions	location.administrative_division.second_level_division_of
medicine.infectious_disease.vector	medicine.vector_of_disease.disease
opera.opera_production.stage_director	opera.opera_director.operas_directed
organization.non_profit_organization.registered_with	organization.non_profit_registration.non_profit_organization
rail.electric_locomotive_class.electric_system_s	rail.electric_system.locomotive_class
rail.locomotive_class.locomotives_of_this_class	rail.locomotive.locomotive_class
rail.rail_network.railways	rail.railway.part_of_network
religion.religious_order.monasteries	religion.monastery.religious_order
visual_art.artwork_owner_relationship.owner	visual_art.art_owner.artworks_owned
business.employment_tenure.title	business.job_title.people_with_this_title
language.language_family.sub_families	language.language_family.member_of_language_families
rail.locomotive_class.built_by	rail.locomotive_builder.locomotive_classes_built
religion.religion.branched_into	religion.religion.branched_from
royalty.order_of_chivalry.category	royalty.order_of_chivalry_category.orders_in_this_category
sports.sports_team.location	sports.sports_team_location.teams
sports.sports_team.team_mascot	sports.mascot.team
tennis.tennis_tournament_championship.winner	tennis.tennis_tournament_champion.tennis_titles
american_football.football_game.rushing	american_football.game_rushing_statistics.game
astronomy.celestial_object_category.subcategory_of	astronomy.celestial_object_category.subcategories
business.product_theme.products	business.consumer_product.themes
education.educational_institution.campuses	education.educational_institution_campus.educational_institution
measurement_unit.unit_of_density.measurement_system	measurement_unit.measurement_system.density_units
medicine.diagnostic_test_signs.sign	medicine.diagnostic_sign.tests
organization.organization_committee_title.members_with_this_title	organization.organization_committee_membership.title
organization.organization_relationship.child	organization.organization.parent
tv.tv_producer_term.producer_type	tv.tv_producer_type.tv_producers_of_this_type
astronomy.galactic_interaction.interaction_type	astronomy.galactic_interaction_type.galaxy_s_interacting_this_way
broadcast.tv_affiliation_duration.station	broadcast.tv_station.affiliations
business.brand_slogan.slogan	business.advertising_slogan.brand
computer.programming_language.language_paradigms	computer.programming_language_paradigm.languages
cvg.computer_game_evaluation.content_descriptors	cvg.computer_game_content_descriptor.versions_with_this_descriptor
geology.rock_type.parent_rock_type	geology.rock_type.sub_types
government.legislative_committee_membership.member	government.politician.legislative_committees_served_on
internet.top_level_domain.registry	internet.top_level_domain_registry.domains
law.court.superior_courts	law.court.inferior_courts
people.deceased_person.cause_of_death	people.cause_of_death.people
amusement_parks.ride.manufacturer	amusement_parks.ride_manufacturer.rides
location.country.first_level_divisions	location.administrative_division.first_level_division_of
medicine.drug.brands	medicine.drug_brand.active_ingredients
people.measured_person.measurements	people.human_measurement.person
royalty.chivalric_rank_precedence.rank	royalty.chivalric_rank.order
engineering.channel_access_method.parent_method	engineering.channel_access_method.child_method
engineering.piston_engine.piston_configuration	engineering.piston_configuration.engines
measurement_unit.measurement_system.weight_units	measurement_unit.mass_unit.measurement_system
media_common.quotation.subjects	media_common.quotation_subject.quotations_about_this_subject
medicine.infectious_disease.transmission	medicine.transmission_route.infections_that_travel_this_way
olympics.olympic_event_competition.venue	olympics.olympic_venue.olympic_events_contested_here
rail.locomotive_class.used_by	rail.locomotive_class_operator_relationship.locomotive_class
cvg.cvg_platform_family.platforms	cvg.cvg_platform.platform_family
dataworld.information_source.attribution_template	dataworld.attribution_template.source
fictional_universe.fictional_universe.created_by	fictional_universe.fictional_universe_creator.fictional_universes_created
government.government_position_held.governmental_body	government.governmental_body.members
language.language_writing_system.child_writing_systems	language.language_writing_system.parent_writing_systems
measurement_unit.force_moment_unit.measurement_system	measurement_unit.measurement_system.force_moment_units
protected_sites.natural_or_cultural_site_designation.categories	protected_sites.site_listing_category.category_of
rail.steam_locomotive_class.fuel_type	rail.steam_locomotive_fuel_type.used_by
royalty.system_of_nobility.supercedes	royalty.system_of_nobility.superceded_by
sports.sports_team_roster.player	sports.pro_athlete.teams
tv.tv_crew_gig.episode	tv.tv_series_episode.other_crew
tv.tv_program_writer_relationship.writer	tv.tv_writer.tv_programs
award.hall_of_fame_induction_category.inductees	award.hall_of_fame_induction.category
book.school_or_movement.associated_authors	book.author.school_or_movement
comic_books.comic_book_issue.editor	comic_books.comic_book_editor.issues_edited
cvg.game_version.peripheral_classes_supported	computer.computer_peripheral_class.supporting_game_versions
fictional_universe.fictional_organization.parent_organization_in_fiction	fictional_universe.fictional_organization.sub_organization_in_fiction
symbols.coat_of_arms.mantling	symbols.heraldic_mantling.coat_of_arms
theater.play.composer	theater.theatrical_composer.plays_composed
cricket.cricket_team.test_stats	cricket.cricket_team_stats.test_team
cvg.game_version.regions	cvg.computer_game_region.versions_released_in_this_region
measurement_unit.absorbed_dose_rate_unit.measurement_system	measurement_unit.measurement_system.absorbed_dose_rate_units
military.force_strength.resource	military.military_resource.conflicts
radio.radio_program_episode.subjects	radio.radio_subject.episodes_with_this_subject
rail.locomotive_ownership.owner	rail.locomotive_owner.locomotives_owned
travel.guidebook.series	travel.guidebook_series.guidebooks
american_football.football_game.receiving	american_football.game_receiving_statistics.game
astronomy.telescope_type.telescopic_principle	astronomy.telescope_principle_type.telescopic_classifications_of_this_technique
broadcast.radio_affiliation_duration.station	broadcast.radio_station.affiliations
business.market_share.space	business.competitive_space.market_share
computer.computer.includes_models	computer.computer.parent_model
computer.programming_language.influenced	computer.programming_language.influenced_by
conferences.conference.series	conferences.conference_series.conference
conferences.conference_series.subject	conferences.conference_subject.series_of_conferences_about_this
education.academic_post.position_or_title	education.academic_post_title.people_with_this_title
film.performance.special_performance_type	film.special_film_performance_type.film_performance_type
government.election_poll.election	government.election_with_polls.polls
government.election_poll_score.subject	government.polled_entity.poll_scores
measurement_unit.angle_unit.measurement_system	measurement_unit.measurement_system.angle_units
media_common.quotation.source	media_common.quotation_source.quotations
olympics.olympic_torch_relay.olympics	olympics.olympic_games.torchbearers
skiing.ski_lift.runs_served	skiing.ski_run.served_by
sports.competitor_country_relationship.country	sports.sport_country.athletes
astronomy.celestial_object.category	astronomy.celestial_object_category.objects
boxing.boxing_match.titles_at_stake	boxing.boxing_title.matches_with_this_title_at_stake
fashion.garment.specialization_of	fashion.garment.more_specialized_forms
fictional_universe.fictional_setting.setting_type	fictional_universe.type_of_fictional_setting.settings
government.governmental_jurisdiction.government_bodies	government.governmental_body.jurisdiction
ice_hockey.hockey_team.conference	ice_hockey.hockey_conference.teams
internet.website.parent_web_property	internet.website.sub_web_properties
medicine.drug_formulation.routes	medicine.drug_administration_route.drug_formulations
olympics.olympic_games.host_city	olympics.olympic_host_city.olympics_hosted
tennis.tennis_match.event	tennis.tennis_tournament.match_results
biology.plant_disease_triangle.host	biology.plant_disease_host.disease_s
book.audio_book_reader.audio_books_read	book.book_edition.reader
book.magazine_issue.magazine	book.magazine.issues
education.department.institution	education.university.departments
food.recipe.author	food.recipe_author.recipes
internet.top_level_domain.sponsor	internet.top_level_domain_sponsor.domains
law.legal_case_party_relationship.case	law.legal_case.parties
measurement_unit.unit_of_molar_mass.measurement_system	measurement_unit.measurement_system.molar_mass_units
meteorology.tropical_cyclone_season.tropical_cyclones	meteorology.tropical_cyclone.tropical_cyclone_season
music.concert_tour.concert_films_or_videos	music.concert_film.concert_tour
people.profession.specializations	people.profession.specialization_of
tv.tv_episode_segment.guest_personal_appearances	tv.tv_segment_guest_appearance.segment
tv.tv_guest_role.special_performance_type	tv.special_tv_performance_type.episode_performances
automotive.company.make_s	automotive.make.parent_company
cricket.cricket_roster.batting	cricket.cricket_roster_batting.roster
cvg.game_performance.voice_actor	cvg.game_voice_actor.computer_game_voice_performances
film.dubbing_performance.actor	film.actor.dubbing_performances
media_common.unfinished_work.completions	media_common.completion_of_unfinished_work.unfinished_work
music.instrument.family	music.instrument.variation
religion.religion.beliefs	religion.belief.belief_of
theater.play.lyricist	theater.theatrical_lyricist.play_lyrics_written
tv.multipart_tv_episode.episodes	tv.tv_series_episode.part_of_multipart_episode
book.journal_article.journal_publication	book.journal_publication.article
cricket.cricket_player_stats.debut	cricket.cricket_player_debut.player
cricket.cricket_roster.keeping	cricket.cricket_roster_keeping.roster
digicams.digital_camera.viewfinder_type	digicams.camera_viewfinder_type.digital_cameras
film.performance.film	film.film.starring
food.tea.tea_type	food.tea_type.tea
medicine.drug_pregnancy_category.regulating_authority	medicine.drug_regulating_authority.pregnancy_categories_regulated
medicine.physician.medical_specialty	medicine.medical_specialty.physicians_with_this_specialty
music.conducting_tenure.conductor	music.conductor.groups
music.conducting_tenure.ensemble	music.conducted_ensemble.conductors
symbols.coat_of_arms.marshalled_coats_of_arms	symbols.coat_of_arms.marshaled_into
theater.theater_production.performed_at	theater.theater.theatrical_productions_staged_here
aviation.airliner_accident.aircraft	aviation.aviation_incident_aircraft_relationship.incident
award.award_honor.ceremony	award.award_ceremony.awards_presented
cricket.cricket_roster.bowling	cricket.cricket_roster_bowling.roster
cvg.computer_game_distribution_system.games_distributed	cvg.game_version.distributed_through
education.university.fraternities_and_sororities	education.fraternity_sorority.colleges_and_universities
law.court.judges	law.judicial_tenure.court
location.imports_and_exports.exported_to	location.statistical_region.places_imported_from
medicine.disease.includes_diseases	medicine.disease.parent_disease
medicine.drug.mechanism_of_action	medicine.drug_mechanism_of_action.drugs_with_this_mechanism_of_action
sports.competitor_competition_relationship.competitors	sports.tournament_event_competitor.events_competed_in
bicycles.bicycle_manufacturer.bicycle_models	bicycles.bicycle_model.manufacturer
computer.computer.key_designers	computer.computer_designer.computers_designed
conferences.conference_series.type_of_conference	conferences.type_of_conference.conferences_of_this_type
education.department.field	education.field_of_study.academic_departments
fictional_universe.fictional_character.powers_or_abilities	fictional_universe.character_powers.characters_with_this_ability
government.government_service.issues_permit	government.government_issued_permit.issuing_service
law.legal_case_party_relationship.role	law.legal_party_role.parties
music.composition.recordings	music.recording.song
tv.tv_song_performer.episodes	tv.tv_episode_song_relationship.performers
american_football.player_game_statistics.player	american_football.football_player.games
automotive.model_year.model	automotive.model.model_years
basketball.basketball_team.conference	basketball.basketball_conference.teams
book.poem.meter	book.poetic_meter.poems_with_this_meter
distilled_spirits.infused_spirit.infusion_style	distilled_spirits.infused_spirit_style.infusions
games.game_expansion.game	games.game.expansions
geology.geological_formation.type_of_rock	geology.rock_type.formations
medicine.disease.stages	medicine.disease_stage.stage_of
skiing.ski_area.lifts	skiing.ski_lift.ski_area
theater.play.soundtracks	theater.musical_soundtrack.play
wine.wine.grape_variety	wine.grape_variety_composition.wine
architecture.building.building_function	architecture.building_function.buildings
architecture.engineer.projects	architecture.structure.engineer
biology.gene_ontology_group.data_source	biology.gene_ontology_data_source.group
book.publishing_company.imprints	book.publishing_company.imprint_of
chemistry.isotope.spin	chemistry.particle_spin.isotopes
engineering.mains_power.location	engineering.location_with_mains_power.mains_power_standards
fictional_universe.fictional_universe.works_set_here	fictional_universe.work_of_fiction.part_of_these_fictional_universes
film.film_crew_gig.film_crew_role	film.film_job.films_with_this_crew_job
government.election_poll.location	government.polled_area.election_polls
government.us_presidential_campaign.running_mate	government.us_vice_presidential_campaign.running_mate
military.military_person.participated_in_conflicts	military.military_conflict.military_personnel_involved
music.release.track	music.recording.releases
sports.sports_equipment.sport_used_for	sports.sport.related_equipment
biology.plant_disease.plant_disease_triangle	biology.plant_disease_triangle.plant_disease
book.written_work.part_of_series	book.literary_series.works_in_this_series
dataworld.data_task.depends_on	dataworld.data_task.dependency_of
engineering.battery_size_cell_variation.cell_type	engineering.battery_cell_type.battery_sizes
film.film.film_festivals	film.film_festival_event.films
transportation.bridge.bridge_type	transportation.bridge_type.bridges_of_this_type
astronomy.constellation.bordering_constellations_new	astronomy.constellation_bordering_relationship.constellations
law.legal_case.subject	law.legal_subject.legal_cases
opera.opera_character_voice.opera	opera.opera.characters
rail.rolling_stock_tenure.locomotive	rail.locomotive.ran_on_railways
royalty.monarch.coronation_event	royalty.coronation.monarch
royalty.monarch.kingdom	royalty.kingdom.rulers
skiing.ski_area.lodges	skiing.ski_lodge.ski_area
sports.sports_team.gender	sports.sports_gender.sports_teams
travel.travel_destination.tourist_attractions	travel.tourist_attraction.near_travel_destination
tv.tv_series_episode.season	tv.tv_series_season.episodes
broadcast.content.broadcast	broadcast.broadcast.content
education.educational_institution.newspaper	education.school_newspaper.school
law.constitutional_convention.delegates	law.constitutional_convention_delegate.constitutional_conventions
measurement_unit.measurement_system.time_units	measurement_unit.time_unit.measurement_system
religion.religion.types_of_places_of_worship	religion.type_of_place_of_worship.religion
royalty.order_of_chivalry.officers	royalty.chivalric_order_position_tenure.order
soccer.football_team.league	soccer.football_league_participation.team
travel.accommodation.accommodation_type	travel.accommodation_type.accommodation_of_this_type
visual_art.art_series.artworks	visual_art.artwork.belongs_to_series
biology.gene_ontology_group.group_type	biology.gene_ontology_group_type.group
measurement_unit.conductance_unit.measurement_system	measurement_unit.measurement_system.conductance_units
olympics.olympic_medal_honor.olympics	olympics.olympic_games.medals_awarded
theater.theater_role.role	theater.theater_character.portrayed_by
astronomy.asteroid_group.asteroid_group_members	astronomy.asteroid.member_of_asteroid_group
business.competitive_space_mediator.space	business.competitive_space.company
business.employment_tenure.company	business.employer.employees
distilled_spirits.infused_spirit.base_spirit	distilled_spirits.distilled_spirit_type.infusions
location.neighborhood.neighborhood_of	location.place_with_neighborhoods.neighborhoods
symbols.flag.used_by	symbols.flag_use.flag
tv.tv_song_performer.episode_segments	tv.tv_segment_song_relationship.performers
food.recipe.techniques	food.culinary_technique.recipes
opera.opera_role.opera	opera.opera_production.cast
royalty.chivalric_order_position_tenure.officer	royalty.chivalric_order_officer.offices_held
symbols.flag_use.flag_user	symbols.flag_referent.flag
tv.tv_program_writer_relationship.tv_program	tv.tv_program.recurring_writers
award.category_ceremony_relationship.category	award.award_category.recurring_ceremony
award.hall_of_fame_inductee.hall_of_fame_inductions	award.hall_of_fame_induction.inductee
biology.plant_disease_triangle.source_s	biology.plant_disease_documentation.plant_disease_documentation
book.author.works_written	book.written_work.author
fictional_universe.fictional_calendar_system.used_in_fictional_universes	fictional_universe.fictional_universe.calendar_systems
film.film.subjects	film.film_subject.films
film.personal_film_appearance.type_of_appearance	film.personal_film_appearance_type.film_appearances
measurement_unit.illuminance_unit.measurement_system	measurement_unit.measurement_system.illuminance_units
opera.opera_production_staff_gig.staff_member	opera.opera_production_staff.opera_productions
organization.organization_board_membership.member	business.board_member.organization_board_memberships
rail.locomotive_class.parent_class	rail.locomotive_class.subclasses
tv.multipart_tv_episode.tv_program	tv.tv_program.multipart_episodes
visual_art.artwork_owner_relationship.method_of_acquisition	visual_art.art_acquisition_method.artworks_acquired_in_this_way
astronomy.extraterrestrial_location.contained_by	astronomy.extraterrestrial_location.contains
aviation.airline.IATA_designator	aviation.iata_airline_designator.airline
fictional_universe.fictional_language.where_spoken	fictional_universe.fictional_setting.languages
food.recipe.part_of_recipe_collection	food.recipe_collection.recipes
measurement_unit.electric_field_strength_unit.measurement_system	measurement_unit.measurement_system.electric_field_strength_units
measurement_unit.measuring_instrument.dimension_measured	measurement_unit.dimension.instruments
medicine.drug.active_moieties	medicine.drug_ingredient.active_moiety_of_drug
medicine.drug_formulation.pregnancy_category	medicine.drug_pregnancy_category.drug_formulation
opera.opera_production_staff_gig.opera	opera.opera_production.production_staff
spaceflight.rocket_launch_site.operated_by	spaceflight.space_agency.spaceports
spaceflight.satellite.orbit_type	spaceflight.satellite_orbit_type.satellites
tv.tv_series_episode.director	tv.tv_director.episodes_directed
comic_books.comic_story_printing.issue	comic_books.comic_book_issue.contents
cricket.cricket_coach_tenure.coach	cricket.cricket_coach.teams
film.film.story_by	film.film_story_contributor.film_story_credits
geography.island.island_group	geography.island_group.islands_in_group
military.military_unit.armed_force	military.armed_force.units
protected_sites.site_listing_category.supercategory	protected_sites.site_listing_category.subcategories
skiing.ski_area_ownership.owner	skiing.ski_area_owner.ski_areas_owned
tv.tv_guest_role.character	tv.tv_character.appeared_in_tv_episodes
automotive.platform.successor	automotive.platform.predecessor
cricket.cricket_team.odi_stats	cricket.cricket_team_stats.odi_team
fictional_universe.fictional_employment_tenure.employee	fictional_universe.fictional_character.employers
food.cheese_texture.cheeses	food.cheese.texture
government.indirect_election.electors	government.electoral_college.elections
location.symbol_of_administrative_division.official_symbol_of	location.location_symbol_relationship.symbol
music.release.album	music.album.releases
opera.opera_production.producing_company	opera.opera_company.operas_produced
people.appointment_nomination.position	people.appointed_role.nomination
religion.religion.collective_term_for_adherents	religion.adherents.religion
royalty.system_rank_relationship.rank	royalty.noble_rank.used_in
spaceflight.rocket_stage.rocket	spaceflight.rocket.stages
sports.defunct_sports_team.later_known_as	sports.sports_team.previously_known_as
wine.wine_type.wine_styles	food.wine_style.wine_types
dataworld.gardening_hint.never_merge_with	dataworld.do_not_merge_mediator.never_merge_with
measurement_unit.energy_density_unit.measurement_system	measurement_unit.measurement_system.energy_density_units
music.artist.genre	music.genre.artists
people.appointment_nomination.nominee	people.appointment_nominee.nomination
soccer.football_team.manager	soccer.football_team_management_tenure.team
architecture.museum.type_of_museum	architecture.type_of_museum.museums
business.product_line.predecessor_product_line	business.product_line.successor_product_line
business.stock_ticker_symbol.stock_exchange	finance.stock_exchange.companies_traded
comic_books.comic_book_genre.comic_book_series_in_this_genre	comic_books.comic_book_series.genre
engineering.engine.energy_source	engineering.engine_energy_source.engines
fictional_universe.event_in_fiction.includes_events	fictional_universe.event_in_fiction.included_by_these_events
film.film.film_format	film.film_format.film_format
rail.railway.rolling_stock	rail.rolling_stock_tenure.railway
royalty.order_of_chivalry.recipients	royalty.chivalric_order_membership.order
time.event.included_in_event	time.event.includes_event
travel.travel_destination.climate	travel.travel_destination_monthly_climate.travel_destination
aviation.aircraft_line.models_in_line	aviation.aircraft_model.part_of_line
chemistry.isotope_decay.decay_mode	chemistry.radioactive_decay_mode.isotopes
cricket.cricket_tournament.events	cricket.cricket_tournament_event.tournament
fictional_universe.romantic_involvement.partner	fictional_universe.fictional_character.romantically_involved_with
film.film_festival.focus	film.film_festival_focus.festivals_with_this_focus
geography.mountain_range.mountains	geography.mountain.mountain_range
measurement_unit.magnetic_flux_unit.measurement_system	measurement_unit.measurement_system.magnetic_flux_units
measurement_unit.unit_of_brake_specific_fuel_consumption.measurement_system	measurement_unit.measurement_system.brake_specific_fuel_consumption_units
medicine.drug.marketed_formulations	medicine.drug_formulation.formulation_of
military.military_command.military_commander	military.military_commander.military_commands
people.group_membership.member	people.person.group
sports.competitor_competition_relationship.competition	sports.tournament_event_competition.competitors
theater.theater_production.choreographer	theater.theater_choreographer.plays_choreographed
theater.theater_production_staff_gig.staff_member	theater.theater_production_staff.theater_productions
tv.tv_regular_personal_appearance.appearance_type	tv.non_character_role.tv_regular_personal_appearances
wine.wine.wine_type	wine.wine_type.wines
architecture.lighthouse.tower_shape	architecture.tower_shape.lighthouse_has_shape
biology.genome.chromosome	biology.chromosome.genome
book.journal.discipline	education.field_of_study.journals_in_this_discipline
education.academic.research_areas	education.field_of_study.academics_in_this_field
film.film.featured_film_locations	film.film_location.featured_in_films
music.artist.supporting_artists	music.group_member.artists_supported
rail.railway.type_of_railway	rail.railway_type_relationship.railway
tv.regular_tv_appearance.special_performance_type	tv.special_tv_performance_type.starring_performances
tv.tv_segment_performance.special_performance_type	tv.special_tv_performance_type.segment_performances
astronomy.constellation.meteor_showers	astronomy.meteor_shower.radiant
biology.genome_build.curator	biology.genome_curator.build
broadcast.producer.produces	broadcast.content.producer
computer.computer_processor.manufacturers	computer.processor_manufacturer.processors_manufactured
olympics.olympic_athlete.demonstration_events_competed_in	olympics.demonstration_event_athlete_relationship.athlete
tv.tv_guest_personal_appearance.person	tv.tv_program_guest.appeared_on
fictional_universe.fictional_object.destroyer	fictional_universe.fictional_object_destroyer.fictional_objects_destroyed
media_common.finished_work.completion_of	media_common.completion_of_unfinished_work.finished_work
music.guitar.guitarists	music.guitarist.guitars_played
olympics.olympic_demonstration_competition.venue	olympics.olympic_venue.olympic_events_demonstrated_here
organization.organization.involved_in_merger	organization.organization_merger.organizations_merging
award.award_category.category_of	award.award.category
olympics.olympic_torchbearer.participation_in_relays	olympics.olympic_torch_relay.torchbearer
physics.particle_antiparticle.particle	physics.particle.antiparticle
aviation.airliner_accident.operator	aviation.airline.accidents
comic_books.comic_book_character.created_by	comic_books.comic_book_creator.characters_created
computer.computer_peripheral.compatible_computers	computer.computer.peripherals
computer.operating_system.parent_os	computer.operating_system.includes_os_versions
engineering.engine_category.engines	engineering.engine.category
fictional_universe.fictional_character.ethnicity	fictional_universe.ethnicity_in_fiction.characters_of_this_ethnicity
government.government_agency.jurisdiction	government.governmental_jurisdiction.agencies
measurement_unit.unit_of_resistivity.measurement_system	measurement_unit.measurement_system.resistivity_units
medicine.symptom.includes_symptoms	medicine.symptom.parent_symptom
olympics.olympic_athlete.demonstration_medals_won	olympics.olympic_demonstration_medal_honor.medalist
olympics.olympic_games.events	olympics.olympic_event.olympic_games_contested
opera.opera_designer_gig.designer	opera.opera_designer.operas_designed
opera.opera_production_venue_relationship.opera_production	opera.opera_production.opera_production_venue_relationship
religion.place_of_worship.type_of_place_of_worship	religion.type_of_place_of_worship.places_of_worship
tv.tv_episode_segment.episodes	tv.tv_series_episode.segments
award.award.child_awards	award.award.parent_award
award.hall_of_fame.discipline	award.hall_of_fame_discipline.halls_of_fame
basketball.basketball_conference.divisions	basketball.basketball_division.conference
architecture.building.building_complex	architecture.building_complex.buildings_in_complex
architecture.lighthouse.light_color_range	architecture.light_color_range.lighthouse_having_color_ranges
award.award_nomination.award	award.award_category.nominees
award.long_list_nomination.nominated_work	award.long_listed_work.long_list_nominations
biology.gene.membership	biology.gene_group_membership.gene
cvg.computer_game_evaluation.rating	cvg.computer_game_rating.versions_with_this_rating
food.drinking_establishment.drinking_establishment_type	food.drinking_establishment_type.establishments_of_this_type
government.election_poll.taken_by	government.polling_authority.polls
religion.religious_organization_leadership.jurisdiction	religion.religious_leadership_jurisdiction.leader
sports.boxer.weight_division	sports.boxing_weight_division.boxers_rated_at_this_weight
zoos.zoo.category	zoos.zoo_category.zoos
biology.organism_classification.higher_classification	biology.organism_classification.lower_classifications
book.periodical.subjects	book.periodical_subject.periodicals
business.product_ingredient.ingredients	business.product_ingredient.used_in_other_ingredients
business.shopping_center.owner	business.shopping_center_owner.shopping_centers_owned
comic_books.comic_book_issue.cover_pencils	comic_books.comic_book_penciler.comic_covers_penciled
computer.software_genre.parent_genre	computer.software_genre.subgenres
film.personal_film_appearance.person	film.person_or_entity_appearing_in_film.films
government.government_agency.predecessor_agency	government.government_agency.successor_agency
organization.leadership.role	organization.role.leaders
wine.wine.color	wine.wine_color.wines
zoos.zoo.notable_animals	zoos.animal_captivity.zoo
architecture.lighthouse.light_attributes	architecture.light_attributes.lighthouse_having_attributes
business.issue.trading_symbol	business.stock_ticker_symbol.issue
celebrities.legal_entanglement.offense	celebrities.reason_for_arrest.celebrities_charged_or_arrested
comic_books.comic_book_issue.next_issue	comic_books.comic_book_issue.previous_issue
government.legislative_committee.legislature	government.governmental_body.committees
medicine.drug_formulation.active_ingredients	medicine.drug_ingredient.active_ingredient_of_formulation
medicine.medical_trial.health_authority	medicine.medical_trial_health_authority.medical_trials
tv.tv_guest_personal_appearance.episode	tv.tv_series_episode.guest_personal_appearances
biology.breed_group.breed_registry	biology.breed_registry.breed_groups
biology.chromosome.band	biology.cytogenetic_band.chromosome
food.recipe.dish	food.dish.recipes
government.political_party_tenure.politician	government.politician.party
measurement_unit.resistance_unit.measurement_system	measurement_unit.measurement_system.resistance_units
military.force_strength.military_conflict	military.military_conflict.force_strengths
music.concert_performance.performance_role	music.concert_performance_role.performances
religion.place_of_worship.religion	religion.religion.places_of_worship
sports.golf_facility.courses	sports.golf_course.facility
symbols.coat_of_arms.helm	symbols.heraldic_helm.coat_of_arms
theater.theater_production.producing_company	theater.theater_company.plays_produced
travel.hotel.notable_guests	travel.hotel_guest_visit.hotel_visited
automotive.trim_level.engine	automotive.engine.trim_levels
aviation.airline_airport_presence.airport	aviation.airport.airlines
comedy.comedy_group_membership.member	comedy.comedian.groups
medicine.disease.tests	medicine.diagnostic_test_signs.disease
sports.sports_team_captain_tenure.captain	sports.sports_team_captain.team
aviation.aircraft_designer.aircraft_models_designed	aviation.aircraft_model.designed_by
award.competition.type_of_competition	award.competition_type.competitions_of_this_type
business.currency_sub_unit.currency	finance.currency.sub_units
education.educational_institution.sexes_accepted	education.gender_enrollment.institution
event.disaster.structures_destroyed	event.disaster_affected_structure.destroyed_by_disaster
film.film.songs	film.film_song_relationship.film
food.recipe.equipment	food.culinary_tool.used_in_recipes
location.fr_region.departments	location.fr_department.region
medicine.routed_drug.marketed_formulations	medicine.drug_formulation.routed_drug
military.military_unit.place_of_origin	military.military_unit_place_of_origin.military_units
biology.breed_origin.breeds_originating_here	biology.animal_breed.place_of_origin
boxing.boxing_match.decision	boxing.boxing_decision.matches_ended_with_this_decision
business.company_product_line_relationship.company	business.consumer_company.product_lines
chess.chess_game_participation.game	chess.chess_game.players
government.national_anthem.national_anthem_of	government.national_anthem_of_a_country.anthem
internet.top_level_domain.status	internet.top_level_domain_status.domains
royalty.chivalric_order_position_tenure.chivalric_office	royalty.chivalric_office.position_holders
skiing.ski_run.ski_area	skiing.ski_area.ski_runs
soccer.football_match.substitution	soccer.football_player_substitution.match
travel.hotel.operated_by	travel.hotel_operator.hotels_operated
astronomy.meteorite.source_celestial_body	astronomy.meteorite_source.meteorites
aviation.airport.hub_for	aviation.airline.hubs
biology.breed_registry.recognized_breeds	biology.breed_registration.registry
conferences.conference_sponsor.conferences	conferences.conference_series.sponsoring_organization
cvg.computer_videogame.publisher	cvg.cvg_publisher.games_published
cvg.musical_game_song_relationship.game	cvg.musical_game.songs
government.government_position_held.district_represented	government.political_district.representatives
government.governmental_body.component_bodies	government.governmental_body.body_this_is_a_component_of
people.group_membership.group	people.group.member
skiing.ski_run.rating	skiing.run_rating.ski_runs
travel.hotel_brand.owned_by	travel.hotel_brand_owner.hotel_brands_owned
tv.tv_episode_segment.personal_appearances	tv.tv_segment_personal_appearance.segment
tv.tv_series_episode.tv_rating	tv.tv_rating.tv_episodes
boxing.boxing_title_tenure.title	boxing.boxing_title.champions
business.holding.holder	business.shareholder.holding
event.disaster.survivors	event.disaster_survivor.survived_disasters
film.film.film_set_decoration_by	film.film_set_designer.film_sets_designed
medicine.diagnostic_sign.parent_sign	medicine.diagnostic_sign.includes_signs
medicine.diagnostic_test.parent_test	medicine.diagnostic_test.includes_tests
military.military_posting.post	military.military_post.people_posted_here
rail.steam_locomotive_class.wheel_configuration	rail.steam_locomotive_wheel_configuration.locomotive_classes
visual_art.artwork_location_relationship.artwork	visual_art.artwork.locations
business.product_ingredient.variety_of	business.product_ingredient.generalization_of
comedy.comedy_group_membership.group	comedy.comedy_group.members
education.field_of_study.subdisciplines	education.field_of_study.subdiscipline_of
fictional_universe.fictional_object.composition	fictional_universe.fictional_substance.fictional_object
media_common.netflix_title.netflix_genres	media_common.netflix_genre.titles
military.military_service.unit	military.military_unit.servicemembers
olympics.olympic_games.demonstration_competitions	olympics.olympic_demonstration_competition.olympics_contested_as_demonstration
sports.competitor_country_relationship.competitor	sports.tournament_event_competitor.country
travel.transportation.transport_operator	travel.transport_operator.travel_destinations_served
wine.wine.wine_sub_region	wine.wine_sub_region.wines
architecture.engineer.partner_in_firm	architecture.engineering_firm.partners
aviation.comparable_aircraft_relationship.aircraft	aviation.aircraft_model.comparable_aircraft
business.company_name_change.company	organization.organization.previous_names
exhibitions.exhibition.curators	exhibitions.exhibition_curator.exhibitions_curated
government.election_campaign.candidate	government.politician.election_campaigns
interests.hobbyist.hobbies	interests.hobby.people_with_this_hobby
measurement_unit.amount_concentration_unit.measurement_system	measurement_unit.measurement_system.amount_concentration_units
media_common.adaptation.adapted_from	media_common.adapted_work.adaptations
tv.tv_network_duration.network	tv.tv_network.programs
astronomy.comet.comet_group	astronomy.comet_group.comet
book.book_edition.isbn	book.isbn.book_editions
chemistry.chemical_element.discoverer	chemistry.element_discoverer.discovered
cvg.video_game_soundtrack.video_game	cvg.computer_videogame.soundtracks
fictional_universe.work_of_fiction.setting	fictional_universe.fictional_setting.works_set_here
film.film_film_company_relationship.film_company	film.film_company.films
amusement_parks.ride.park	amusement_parks.park.rides
automotive.engine.fuels_used	automotive.fuel.engines
education.honorary_degree.degree	education.educational_degree.honorary_degree_recipients
geography.geographical_feature_category.subcategories	geography.geographical_feature_category.subcategory_of
medicine.disease.risk_factors	medicine.risk_factor.diseases
music.music_video.music_video_subject	music.music_video_subject.subject_in_these_music_videos
soccer.football_player.position_s	soccer.football_position.players
astronomy.orbital_relationship.orbits	astronomy.orbital_relationship.orbited_by
basketball.basketball_player_career_stats.player	basketball.basketball_player.career_averages
computer.file_format.genre	computer.file_format_genre.file_formats
cricket.cricket_tournament_event.matches	cricket.cricket_match.tournament_event
cvg.computer_game_evaluation.release_rated	cvg.game_version.rating
food.recipe.instructions	food.recipe_instruction.recipe
government.government_service.government_service_type	government.government_service_type.government_service
measurement_unit.measuring_instrument.subclasses	measurement_unit.measuring_instrument.subclass_of
medicine.drug.drug_class	medicine.drug_class.drugs
olympics.olympic_athlete_affiliation.athlete	olympics.olympic_athlete.country
soccer.football_league_season.league	soccer.football_league.seasons
tv.tv_program.theme_song	tv.tv_theme_song.theme_song_for
wine.wine.vineyard	wine.vineyard.wines
aviation.aircraft_model.variants	aviation.aircraft_model.parent_aircraft_model
cvg.computer_game_engine.developer	cvg.computer_game_engine_developer.computer_game_engines_developed
dataworld.provenance.data_operation	dataworld.mass_data_operation.authority
government.governmental_body.offices_positions	government.government_office_or_title.governmental_body_if_any
medicine.medical_trial.type_of_trial	medicine.medical_trial_type.medical_trials
music.music_video_performance.music_video_performer	music.music_video_performer.music_video_performances
olympics.olympic_games.bidding_cities	olympics.olympic_city_bid.olympic_games
radio.radio_episode_segment.subjects	radio.radio_subject.segments_with_this_subject
spaceflight.satellite.orbiting	astronomy.celestial_object.artificial_satellites
time.day_of_week.calendar_system	time.calendar.days_of_week
astronomy.astronomical_discovery.discovery_technique	astronomy.astronomical_discovery_technique.astronomical_discoveries_by_this_method
book.periodical_publisher_period.publisher	book.periodical_publisher.periodicals_published
celebrities.substance_abuse_problem.substance	celebrities.abused_substance.abused_by
cvg.computer_game_engine.engine_family	cvg.computer_game_engine_family.engines_in_this_family
law.invention.inventor	law.inventor.inventions
law.legal_case.court	law.court.legal_cases
metropolitan_transit.transit_line.vehicle_types	metropolitan_transit.transit_vehicle.transit_lines
religion.religion.texts	religion.religious_text.religious_text_of
automotive.transmission_type.transmissions	automotive.transmission.classification
award.award_honor.award_winner	award.award_winner.awards_won
computer.software.software_genre	computer.software_genre.software_in_genre
event.produced_event.produced_by	event.event_producer.events_produced
film.film_cut.film	film.film.runtime
medicine.cancer_center.constituents	medicine.cancer_center_constituent.cancer_center
spaceflight.rocket_engine.designed_by	spaceflight.rocket_engine_designer.rocket_engines
tv.tv_subject.tv_episode_segments	tv.tv_episode_segment.subjects
aviation.airport.serves	location.location.nearby_airports
cvg.computer_game_rating_system.ratings	cvg.computer_game_rating.rating_system
geography.waterfall_type.waterfalls	geography.waterfall.waterfall_type
government.national_anthem_of_a_country.country	location.country.national_anthem
internet.website.status	internet.website_status.sites
chemistry.solubility_relationship.solubility	chemistry.solubility.substances
chess.chess_move.game	chess.chess_game.history
measurement_unit.luminous_flux_unit.measurement_system	measurement_unit.measurement_system.luminous_flux_units
measurement_unit.measurement_system.speed_units	measurement_unit.speed_unit.measurement_system
music.concert_tour.live_recordings	music.live_album.concert_tour
protected_sites.natural_or_cultural_site_listing.category_or_criteria	protected_sites.site_listing_category.listed_sites
symbols.coat_of_arms.charges	symbols.heraldic_charge_color.coat_of_arms
travel.travel_destination.tour_operators	travel.tour_operator.travel_destinations
book.periodical_format_period.format	book.periodical_format.periodicals_in_this_format
exhibitions.exhibition.produced_by	exhibitions.exhibition_producer.exhibitions_produced
film.film_festival_sponsor.festivals_sponsored	film.film_festival_sponsorship.sponsor
food.type_of_dish.dishes	food.dish.type_of_dish1
government.election_poll.type_of_people_polled	government.poll_respondent_category.polls
measurement_unit.catalytic_activity_unit.measurement_system	measurement_unit.measurement_system.catalytic_activity_units
measurement_unit.magnetic_field_strength_unit.measurement_system	measurement_unit.measurement_system.magnetic_field_strength_units
organization.organization_member.committees_served_on	organization.organization_committee_membership.member
projects.project.includes_smaller_projects	projects.project.part_of_larger_project
american_football.football_player.receiving	american_football.player_receiving_statistics.player
aviation.airport.focus_city_for	aviation.airline.focus_cities
biology.breed_registration.breed_group	biology.breed_group.breeds_in_this_group
biology.hybrid_parentage.parent_sex	biology.hybrid_parent_gender.hybrids
book.book_edition.book	book.book.editions
book.book_edition_series.sub_series	book.book_edition_series.part_of_series
book.editorial_tenure.title	book.editor_title.editors
measurement_unit.specific_heat_capacity_unit.measurement_system	measurement_unit.measurement_system.specific_heat_capacity_units
measurement_unit.unit_of_force.measurement_system	measurement_unit.measurement_system.force_units
meteorology.tropical_cyclone.affected_areas	meteorology.cyclone_affected_area.cyclones
military.military_combatant_group.combatants	military.military_combatant.military_conflicts
people.deceased_person.place_of_burial	people.place_of_interment.interred_here
spaceflight.rocket_engine.manufactured_by	spaceflight.rocket_engine_manufacturer.rocket_engines
award.award.nomination_announcements	award.award_nomination_announcement.award
award.recurring_award_ceremony.award_categories	award.category_ceremony_relationship.ceremony
biology.animal_breed.temperament	biology.breed_temperament.breeds
broadcast.radio_affiliation_duration.network	broadcast.radio_network.affiliates
government.government_position_held.office_position_or_title	government.government_office_or_title.office_holders
government.political_party_tenure.party	government.political_party.politicians_in_this_party
location.location.partially_contains	location.location.partially_containedby
measurement_unit.molar_volume_unit.measurement_system	measurement_unit.measurement_system.molar_volume_units
royalty.noble_title.used_in	royalty.system_title_relationship.title
soccer.football_match.disciplinary_action	soccer.football_disciplinary_action.match
government.governmental_jurisdiction.government_positions	government.government_office_or_title.jurisdiction
location.statistical_region.places_exported_to	location.imports_and_exports.imported_from
measurement_unit.measurement_system.data_rate_units	measurement_unit.unit_of_data_transmission_rate.measurement_system
medicine.disease.symptoms	medicine.symptom.symptom_of
medicine.hospital.ownership_status	medicine.hospital_ownership.hospital
cvg.computer_videogame.sequel	cvg.computer_videogame.prequel
dataworld.mass_data_operation.information_source	dataworld.information_source.data_operations
government.government_office_category.offices	government.government_office_or_title.category
government.political_party.ideology	government.political_ideology.political_parties
religion.place_of_worship.historically_used_by_religions	religion.place_of_worship_historical_use.place_of_worship
sports.boxer.stance	sports.boxing_stance.boxers_with_this_stance
automotive.option_package.options	automotive.option.option_packages
celebrities.romantic_relationship.celebrity	celebrities.celebrity.sexual_relationships
comic_books.comic_book_story.colors	comic_books.comic_book_colorist.comic_stories_colored
digicams.digital_camera.image_stabilization	digicams.image_stabilization_type.digital_camera
engineering.piston_engine.valvetrain_configuration	engineering.valvetrain_configuration.engines
medicine.drug.physiologic_effect	medicine.drug_physiologic_effect.drugs_with_this_physiologic_effect
visual_art.art_period_movement.associated_artworks	visual_art.artwork.period_or_movement
astronomy.galaxy.constellation	astronomy.constellation.galaxies_observed_in_constellation
cricket.cricket_series_event.matches	cricket.cricket_match.series_event
cvg.game_performance.game	cvg.computer_videogame.characters
film.dubbing_performance.film	film.film.dubbing_performances
measurement_unit.measurement_system.energy_units	measurement_unit.energy_unit.measurement_system
royalty.order_of_chivalry.used_in	royalty.system_order_relationship.order
spaceflight.rocket_stage.engine	spaceflight.rocket_engine.used_in_rocket_stages
automotive.designer.automobiles_designed	automotive.generation.designer
basketball.basketball_team.division	basketball.basketball_division.teams
business.employment_tenure.person	people.person.employment_history
cvg.musical_game_song_relationship.song	cvg.musical_game_song.games
film.dubbing_performance.character	film.film_character.portrayed_in_films_dubbed
skiing.run_rating.symbol	skiing.run_rating_symbol.run_rating
soccer.football_match.assistant_referees	soccer.football_referee.assistant_referee_at
spaceflight.spacecraft.manufacturer	spaceflight.satellite_manufacturer.spacecraft_manufactured
aviation.airport_runway.airport	aviation.airport.runway_information
broadcast.broadcast.distributor	broadcast.distributor.distributes
dataworld.provenance.tool	dataworld.software_tool.provenances
education.athletics_brand.institution	education.educational_institution.athletics_brand
martial_arts.martial_arts_certification.certifying_body	martial_arts.martial_arts_organization.qualifications_awarded
measurement_unit.permittivity_unit.measurement_system	measurement_unit.measurement_system.permittivity_units
military.military_command.military_combatant	military.military_combatant.military_commanders
opera.opera_production_venue_relationship.opera_house	opera.opera_house.opera_production_venue_relationship
physics.hadron.composition	physics.subatomic_particle_composition.composes
architecture.structure.destroyed_by	architecture.destruction_method.structures_destroyed
astronomy.star_system.plutoids	astronomy.plutoid.star_system
astronomy.telescope.operational_platform	astronomy.telescope_platform.telescopes_based_on_this
aviation.airline.ICAO_designator	aviation.icao_airline_designator.airline
biology.taxon_with_sequenced_genome.genome	biology.genome.taxon
conferences.conference.focus	conferences.conference_subject.specific_conferences_about_this
education.education.major_field_of_study	education.field_of_study.students_majoring
food.beer.beer_style	food.beer_style.beers
sports.team_venue_relationship.venue	sports.sports_facility.home_venue_for
sports.tournament_event.tournaments_contested_in	sports.multi_event_tournament.events
tv.tv_program.program_creator	tv.tv_program_creator.programs_created
amusement_parks.ride.designer	amusement_parks.ride_designer.rides
aviation.airport_operator.airports_operated	aviation.airport.operator
award.award_announcement.award_categories	award.award_category.award_announcements
basketball.basketball_team_stats.team	basketball.basketball_team.team_stats
boats.ship_class.powerplant	boats.ship_powerplant_system.ship_classes_powered
fictional_universe.fictional_character.rank	fictional_universe.character_rank.characters_of_this_rank
film.film.written_by	film.writer.film
food.diet.followers	food.diet_follower.follows_diet
government.electoral_college.offices	government.electoral_college_elected_office.electoral_college
medicine.medical_treatment.contraindications	medicine.contraindication.contraindication_for
medicine.medical_trial.sponsor	medicine.medical_trial_sponsor.trials_sponsored
olympics.olympic_sport.olympic_games_contested	olympics.olympic_games.sports
royalty.system_of_nobility.ranks	royalty.system_rank_relationship.system
soccer.football_match.players	soccer.football_player_match_participation.match
soccer.football_match.teams	soccer.football_team.matches
sports.sports_league_draft_pick.player	sports.drafted_athlete.drafted
biology.animal_breed.coloring	biology.breed_coloring.breeds
boats.ship_class.ship_type	boats.ship_type.ship_class
business.industry.parent_industry	business.industry.child_industry
comic_books.comic_book_issue.cover_inks	comic_books.comic_book_inker.comic_covers_inked
cricket.cricket_coach.current_team	cricket.cricket_team.coach
digicams.digital_camera.camera_sensor_manufacturer	digicams.camera_sensor_manufacturer.cameras
fictional_universe.event_in_fiction.appears_in_these_works	fictional_universe.work_of_fiction.events
finance.currency.countries_used	location.country.currency_used
games.game.designer	games.game_designer.games_designed
measurement_unit.measurement_system.pressure_units	measurement_unit.pressure_unit.measurement_system
meteorology.cloud.varieties	meteorology.cloud.cloud_family
theater.theater_production_venue_relationship.theater_production	theater.theater_production.theater_production_venue_relationship
wine.wine.appellation	wine.appellation.wines
book.author.works_edited	book.written_work.editor
book.book_character.appears_in_stories	book.short_story.characters
book.publishing_company.imprint	book.publisher_imprint_tenure.publisher
government.government_position_held.appointed_by	government.political_appointer.appointees
government.legislative_committee_membership.committee	government.legislative_committee.members
measurement_unit.volumetric_heat_capacity_unit.measurement_system	measurement_unit.measurement_system.volumetric_heat_capacity_units
medicine.manufactured_drug_form.manufacturer	medicine.drug_manufacturer.drugs_manufactured
people.person.place_of_birth	location.location.people_born_here
sports.sports_official.sports_association	sports.sports_official_tenure.sports_official
american_football.football_division.conference	american_football.football_conference.divisions
education.athletics_brand.teams	sports.school_sports_team.athletics_brand
education.education.student	people.person.education
olympics.olympic_participating_country.olympics_participated_in	olympics.olympic_games.participating_countries
people.marriage.type_of_union	people.marriage_union_type.unions_of_this_type
biology.animal_breed.registered_with	biology.breed_registration.breed
dataworld.type_project_mediator.type_project	dataworld.type_project.types_needing_work
fictional_universe.fictional_character.gender	fictional_universe.character_gender.characters_of_this_gender
fictional_universe.fictional_organization_type.organizations	fictional_universe.fictional_organization.type_of_organization
geography.geographical_feature.category	geography.geographical_feature_category.features
media_common.lost_work.reason_for_loss	media_common.cause_of_loss.works_lost_this_way
meteorology.tropical_cyclone.category	meteorology.tropical_cyclone_category.tropical_cyclones
sports.sports_league_draft_pick.draft	sports.sports_league_draft.picks
american_football.football_player.passing	american_football.player_passing_statistics.player
boats.ship_class.designer	boats.ship_designer.ship_classes_designed
book.author.book_editions_edited	book.book_edition.editor_of_this_edition
book.interview.interviewee	book.interviewee.interviews_given
book.literary_series.author_s	book.author.series_written_or_contributed_to
cvg.computer_videogame.mods	cvg.computer_game_mod.game_modded
education.department.subsidiary_departments	education.department.department_of
event.speech_or_presentation.speaker_s	event.public_speaker.speeches_or_presentations
film.film.featured_song	film.film_featured_song.featured_in_film
music.track_contribution.contributor	music.artist.track_contributions
travel.hotel_grade.awarded_by	travel.hotel_grading_authority.grades_awarded
astronomy.astronomical_discovery.discovery_site	astronomy.astronomical_observatory.discoveries
book.review.work_reviewed	book.reviewed_work.reviews_of_this_work
business.product_line.parent_product_line	business.product_line.includes_product_lines
conferences.conference_proceedings.conference	conferences.conference.proceedings
cvg.computer_videogame.influenced	cvg.computer_videogame.influenced_by
fictional_universe.fictional_object.owner	fictional_universe.fictional_character.has_possessed
medicine.medical_treatment.side_effects	medicine.symptom.side_effect_of
meteorology.tropical_cyclone_category.Beaufort_scale	meteorology.beaufort_wind_force.tropical_cyclone_categories
music.concert.concert_video	music.concert_film.concert
symbols.coat_of_arms.bearers	symbols.armorial_grant.coat_of_arms
time.day_of_year.calendar_system	time.calendar.days_of_year
american_football.football_game.away_team	american_football.football_team.away_games
award.award_judging_term.judge	award.award_judge.awards_judged
book.book_edition_series.series_editor	book.series_editor.book_edition_series_edited
business.consumer_product.brand	business.brand.products
cricket.cricket_roster.team_batting	cricket.team_inning_batting_stats.roster
cvg.computer_videogame.peripherals_supported	computer.computer_peripheral.supporting_games
fashion.designer_label_association.label	fashion.fashion_label.designers
religion.religious_organization.member_organizations	religion.religious_organization.is_member_of
computer.software_license.versions	computer.software_license.version_of
interests.collection_category.parent_category	interests.collection_category.sub_categories
law.us_patent.international_classification	law.international_patent_category.patents
measurement_unit.exposure_unit.measurement_system	measurement_unit.measurement_system.exposure_units
music.concert_tour.concerts	music.concert.concert_tour
soccer.football_player_match_participation.player	soccer.football_player.matches_played
tv.tv_series_episode.songs	tv.tv_episode_song_relationship.episode
architecture.structure.architecture_firm	architecture.architecture_firm.projects
astronomy.trans_neptunian_object.region	astronomy.trans_neptunian_region.trans_neptunian_objects
aviation.airliner_accident.accident_type	aviation.accident_type.aircraft_accidents_of_this_type
award.award.presented_by	award.award_presenting_organization.awards_presented
book.illustrator.magazine_covers	book.magazine_issue.cover_artist
dataworld.attribution_namespace.attribution_template	dataworld.attribution_template.attribution_namespace
engineering.engine.variants	engineering.engine.variation_of
film.film_film_company_relationship.role_service	film.film_company_role_or_service.companies_performing_this_role_or_service
military.military_service.military_force	military.armed_force.personnel
religion.religion.practices	religion.religious_practice.practice_of
business.product_line.products	business.consumer_product.product_line
computer.web_browser.layout_engine	computer.html_layout_engine.browsers
cvg.computer_videogame.developer	cvg.cvg_developer.games_developed
fictional_universe.fictional_character.place_of_birth	fictional_universe.fictional_setting.fictional_characters_born_here
measurement_unit.angular_velocity_unit.measurement_system	measurement_unit.measurement_system.angular_velocity_units
time.time_zone.locations_in_this_time_zone	location.location.time_zones
tv.tv_episode_segment.writer	tv.tv_writer.tv_segments_written
automotive.trim_level.transmission	automotive.transmission.trim_levels
award.award_nomination_announcement.award_categories	award.award_category.nomination_announcement
award.competition.winner	award.competitor.competitions_won
business.company_product_relationship.consumer_product	business.consumer_product.company
business.sponsorship.sponsored_recipient	business.sponsored_recipient.sponsorship
interests.collection_activity.type_of_thing_collected	interests.collection_category.name_of_collection_activity
measurement_unit.catalytic_concentration_unit.measurement_system	measurement_unit.measurement_system.catalytic_concentration_units
music.album.album_content_type	music.album_content_type.albums
olympics.olympic_demonstration_competition.competitors	olympics.demonstration_event_athlete_relationship.competition
soccer.football_player_transfer.selling_team	soccer.football_team.sold_players
sports.sports_team.season_record	sports.sports_team_season_record.team
theater.theater_designer_gig.designer	theater.theater_designer.plays_designed
time.holiday.type_of_holiday	time.holiday_category.holidays
american_football.football_historical_coach_position.coach	american_football.football_coach.coaching_history
automotive.model.automotive_class	automotive.automotive_class.examples
aviation.airport.terminals	aviation.airport_terminal.airport
computer.computer_peripheral.peripheral_class	computer.computer_peripheral_class.products
distilled_spirits.blended_spirit.style	distilled_spirits.blended_spirit_style.blends
event.promoted_event.promoted_by	event.event_promoter.events_promoted
event.speech_or_presentation.type_or_format_of_presentation	event.type_of_public_presentation.presentations_of_this_type
fictional_universe.fictional_character.places_lived	fictional_universe.fictional_setting.characters_that_have_lived_here
fictional_universe.fictional_universe.literary_series_set_here	book.literary_series.fictional_universe
measurement_unit.absorbed_dose_unit.measurement_system	measurement_unit.measurement_system.absorbed_dose_units
measurement_unit.angular_acceleration_unit.measurement_system	measurement_unit.measurement_system.angular_acceleration_units
organization.organization.founders	organization.organization_founder.organizations_founded
symbols.coat_of_arms.brisures	symbols.heraldic_brisure.coat_of_arms
amusement_parks.accident.ride	amusement_parks.ride.accidents
cvg.computer_videogame.cvg_genre	cvg.cvg_genre.games
education.education.institution	education.educational_institution.students_graduates
finance.stock_exchange.operated_by	finance.exchange_operator_relationship.exchange
interests.collection.items	interests.collectable_item.in_collections
music.concert_tour.album_or_release_supporting	music.album.supporting_tours
opera.opera_character_voice.character	opera.opera_character.operas_appears_in
tv.tv_producer_episode_credit.role	tv.tv_producer_type.episodes_with_this_role
astronomy.extraterrestrial_location.geolocation	astronomy.planetographic_coordinate.extraterrestrial_location
astronomy.near_earth_object.near_earth_object_classification	astronomy.near_earth_object_classification.near_earth_objects
biology.gene_group_membership.evidence	biology.gene_group_membership_evidence.membership
business.brand.slogans	business.brand_slogan.brand
engineering.piston_engine.cooling_method	engineering.engine_cooling_method.engines
ice_hockey.hockey_team.coach	ice_hockey.hockey_coach.current_team
organization.organization_board_membership.role	organization.role.governors
skiing.lift_tenure.lift_type	skiing.lift_type.ski_lifts
soccer.football_team.borrowed_players	soccer.football_player_loan.borrowing_team
time.event.locations	location.location.events
tv.tv_location.tv_episodes_filmed_here	tv.tv_series_episode.filming_locations
award.award_nomination.award_nominee	award.award_nominee.award_nominations
basketball.basketball_player.position_s	basketball.basketball_position.players
broadcast.tv_station_owner.tv_stations	broadcast.tv_station.owner
digicams.digital_camera.supported_storage_types	digicams.camera_storage_type.compatible_cameras
food.candy_bar.manufacturer	food.candy_bar_manufacturer.candy_bars
games.playing_card_game.deck_type	games.playing_card_deck_type.card_games
location.hud_county_place.county	location.us_county.hud_county_place
medicine.disease.trials	medicine.medical_trial.diseases
american_football.football_player.rushing	american_football.player_rushing_statistics.player
architecture.engineering_firm.projects	architecture.structure.engineering_firm
astronomy.asteroid_family.asteroid_family_member	astronomy.asteroid.member_of_asteroid_family
comic_strips.comic_strip_creator_duration.comic_strip	comic_strips.comic_strip.creator_of_strip
cvg.computer_game_expansion.expansion_for	cvg.computer_videogame.expansions
location.administrative_division.capital	location.administrative_division_capital_relationship.administrative_division
music.music_video.performances	music.music_video_performance.music_video
spaceflight.bipropellant_rocket_engine.fuel	spaceflight.rocket_engine_fuel.rocket_engines
transportation.road.orientation	transportation.road_orientation.roads_with_this_orientation
award.award_achievement_level.winners	award.award_honor.achievement_level
book.cited_work.cited_in	book.scholarly_work.works_cited
book.illustrator.book_editions_illustrated	book.book_edition.interior_illustrations_by
broadcast.content.genre	broadcast.genre.content
comic_strips.comic_strip_creator_duration.creator_role	comic_strips.comic_strip_creator_role.creators
cvg.computer_game_subject.games	cvg.computer_videogame.subjects
digicams.digital_camera.color_filter_array_type	digicams.camera_color_filter_array_type.cameras
law.litigant.party_to_cases	law.legal_case_party_relationship.parties
measurement_unit.current_unit.measurement_system	measurement_unit.measurement_system.current_units
measurement_unit.molar_heat_capacity_unit.measurement_system	measurement_unit.measurement_system.molar_heat_capacity_units
medicine.drug_formulation.manufactured_forms	medicine.manufactured_drug_form.manufactured_form_of
military.military_person.service	military.military_service.military_person
olympics.olympic_torch_relay.location	olympics.olympic_torch_relay_location.olympics
spaceflight.bipropellant_rocket_engine.oxidizer	spaceflight.rocket_engine_oxidizer.rocket_engines
sports.sports_league.championship	sports.sports_championship.league
tv.tv_song.episodes	tv.tv_episode_song_relationship.song
american_football.football_game_score.game	american_football.football_game.game_scores
architecture.building_complex.complex_function	architecture.building_complex_function.building_complexes
comic_strips.comic_strip_syndicate_duration.comic_strip	comic_strips.comic_strip.syndicate
cvg.computer_videogame.uses_game_engine	cvg.computer_game_engine.used_for_computer_games
food.wine_style.place_of_origin	wine.wine_region.wine_styles
internet.blog.blogger	internet.blogger.blog
law.constitutional_amendment.proposed_by	law.constitutional_amendment_proposer.constitutional_amendments_proposed
music.composition.form	music.compositional_form.compositions
music.genre.subgenre	music.genre.parent_genre
spaceflight.satellite_type.satellites	spaceflight.satellite.primary_use
automotive.manufacturing_plant.company	automotive.company.manufacturing_plants
biology.organism_classification_rank.lower_rank	biology.organism_classification_rank.higher_rank
business.trade_union.industry	business.industry.trade_unions
digicams.digital_camera.compressed_formats	digicams.camera_compressed_format.cameras
film.film.music	film.music_contributor.film
measurement_unit.luminance_unit.measurement_system	measurement_unit.measurement_system.luminance_units
medicine.routed_drug.routed_drug_of	medicine.drug.routed_drugs
meteorology.cloud.classification	meteorology.cloud_classification.clouds
music.group_membership.member	music.group_member.membership
symbols.armorial_grant.granted_by	symbols.heraldry_granting_body.coats_of_arms_granted
tennis.tennis_match.winner	tennis.tennis_player.matches_won
tv.tv_regular_personal_appearance.program	tv.tv_program.regular_personal_appearances
automotive.generation.years	automotive.model_year.generation
automotive.manufacturing_plant_model_relationship.manufacturing_plant	automotive.manufacturing_plant.models_manufactured
biology.chromosome.locus	biology.genomic_locus.chromosome
business.asset_ownership.owner	business.asset_owner.assets_owned
distilled_spirits.distilled_spirit_type.fermentation_base	distilled_spirits.fermentation_base.spirit_products
location.administrative_division_capital_relationship.capital_type	location.capital_category.capitals_of_administrative_divisions
rail.locomotive_class.gauge	rail.rail_gauge.locomotive_classes
religion.religious_leadership_jurisdiction.size_or_type	religion.religious_jurisdiction_class.jurisdiction
cvg.game_version.game	cvg.computer_videogame.versions
food.dish.cuisine	dining.cuisine.dishes
government.government_position_held.jurisdiction_of_office	government.governmental_jurisdiction.governing_officials
law.judicial_tenure.judge	law.judge.courts
music.music_video_gig.music_video_crew_production_role	music.music_video_job.music_videos_with_this_crew_job
book.written_work.next_in_series	book.written_work.previous_in_series
business.business_operation.major_customer	business.customer.supplier
chemistry.chemical_element.periodic_table_block	chemistry.periodic_table_block.elements
cricket.cricket_coach_tenure.team	cricket.cricket_team.coaches
cvg.game_performance.performance_type	cvg.computer_game_performance_type.performances
games.game.publisher	games.game_publisher.games_published
media_common.quotation.addressee	media_common.quotation_addressee.quotations
medicine.hospital_ownership.ownership_status	medicine.hospital_ownership_status.hospitals
music.music_video.choreographer	music.music_video_choreographer.music_videos_choreographed
music.recording_contribution.performance_role	music.performance_role.guest_performances
olympics.olympic_event.sport	olympics.olympic_sport.events
people.person.profession	people.profession.people_with_this_profession
theater.theater_production.director	theater.theater_director.plays_directed
tv.tv_location.tv_shows_filmed_here	tv.tv_program.filming_locations
astronomy.celestial_object_with_coordinate_system.planetographic_coordinate_system	astronomy.planetographic_coordinate_system.celestial_object
chemistry.chemical_compound.solubility	chemistry.solubility_relationship.solute
media_common.literary_genre.books_in_this_genre	book.book.genre
media_common.media_genre.equivalent_topic	media_common.media_genre_equivalent_topic.media_genre_equivalent
music.recording.featured_artists	music.featured_artist.recordings
radio.radio_program_episode.segments	radio.radio_episode_segment.episode
skiing.ski_lift.lift_type	skiing.lift_tenure.ski_lift
basketball.basketball_historical_coach_position.team	basketball.basketball_team.previous_coaches
computer.software.protocols_used	computer.internet_protocol.software_used_by
fictional_universe.fictional_character.occupation	fictional_universe.character_occupation.characters_with_this_occupation
measurement_unit.current_density_unit.measurement_system	measurement_unit.measurement_system.current_density_units
olympics.olympic_mascot.olympic_games	olympics.olympic_games.mascot
religion.religion.holidays	time.holiday.featured_in_religions
tennis.tennis_match.loser	tennis.tennis_player.matches_lost
award.long_list_nomination.nominee	award.long_list_nominee.long_list_nominations
biology.fossil_specimen.found_at_site	biology.fossil_site.specimens_found_here
business.product_ingredient.derived_from	business.product_ingredient.derivatives
education.educational_institution.subsidiary_or_constituent_schools	education.educational_institution.parent_institution
opera.opera.genre	opera.opera_genre.operas_in_this_genre
american_football.football_historical_coach_position.team	american_football.football_team.historical_coaching_staff
business.consumer_company.products	business.company_product_relationship.company
business.product_endorsement.endorsee	business.product_endorsee.endorsements
celebrities.friendship.friend	celebrities.celebrity.celebrity_friends
computer.computer_emulator.computer	computer.computer.emulators
film.film.soundtrack	music.soundtrack.film
film.film_film_distributor_relationship.film	film.film.distributors
food.recipe.suitable_for_diets	food.diet.recipes
organization.organization_spin_off.parent_company	organization.organization.spin_offs
protected_sites.protected_site.iucn_category	protected_sites.iucn_category.protected_areas
rail.railway_gauge_relationship.gauge	rail.rail_gauge.railways
royalty.chivalric_title.opposite_gender_equivalent	royalty.chivalric_title_gender_equivalency.equivalent_titles
tv.tv_segment_personal_appearance.person	tv.tv_personality.tv_segment_appearances
book.periodical.format	book.periodical_format_period.periodical
celebrities.legal_entanglement.celebrity	celebrities.celebrity.legal_entanglements
computer.web_browser.extensions	computer.web_browser_extension.works_on_web_browser
measurement_unit.capacitance_unit.measurement_system	measurement_unit.measurement_system.capacitance_units
measurement_unit.electric_flux_density_unit.measurement_system	measurement_unit.measurement_system.electric_flux_density_units
measurement_unit.solid_angle_unit.measurement_system	measurement_unit.measurement_system.solid_angle_units
soccer.football_match.referee	soccer.football_referee.main_referee_for
soccer.football_player_stats.team	soccer.football_team.player_statistics
sports.sports_team.venue	sports.team_venue_relationship.team
symbols.heraldic_variation_of_the_field_color.variation_of_the_field	symbols.heraldic_variation_of_the_field.coat_of_arms
theater.theater_production.musical_director	theater.musical_director.musical_director_for
amusement_parks.disney_ride_ticket_membership.ticket	amusement_parks.disney_ride_ticket.rides
book.journal.articles	book.journal_publication.journal
boxing.boxing_title_tenure.weight	sports.boxing_weight_division.champions
education.fraternity_sorority.fraternity_sorority_type	education.fraternity_sorority_type.fraternities_and_sororities
fictional_universe.fictional_employment_tenure.title	fictional_universe.fictional_job_title.fictional_characters_with_this_job
language.language_writing_system.languages	language.human_language.writing_system
measurement_unit.electric_charge_density_unit.measurement_system	measurement_unit.measurement_system.electric_charge_density_units
olympics.olympic_event.demonstration_competitions	olympics.olympic_demonstration_competition.event
opera.opera_production.recordings	opera.opera_recording.production
rail.railway_operator_relationship.operator	rail.railway_operator.railways
travel.accommodation.features	travel.accommodation_feature.accommodation_with_this_feature
astronomy.galactic_cluster.galaxy_supercluster	astronomy.galactic_super_cluster.galaxy_clusters
book.illustrator.book_edition_covers	book.book_edition.cover_artist
business.product_line.brand	business.brand.product_lines
computer.software_compatibility.software	computer.software.compatible_oses
food.cheese.source_of_milk	food.cheese_milk_source.cheeses
music.artist.tribute_acts	music.musical_tribute_act.tribute_of
music.concert.performances	music.concert_performance.concert
organization.organization.sectors	organization.organization_sector.organizations_in_this_sector
sports.sports_team.fight_song	sports.fight_song.sports_team
visual_art.artwork.art_genre	visual_art.visual_art_genre.artworks
zoos.zoo.exhibits	zoos.zoo_exhibit.zoo
astronomy.star.spectral_type	astronomy.spectral_type.celestial_objects_of_this_spectral_type
award.award_category.long_lists	award.long_list_nomination.award
boats.ship.designer	boats.ship_designer.boats_designed
food.beer.from_region	food.beer_country_region.beers_from_here
military.military_combatant.includes_allies	military.military_combatant.belongs_to_combatant_group
music.concert.venue	music.performance_venue.concerts
royalty.royal_line.preceded_by	royalty.royal_line.succeeded_by
business.acquisition.company_acquired	organization.organization.acquired_by
education.honorary_degree.recipient	education.honorary_degree_recipient.honorary_degrees
spaceflight.space_mission.launch_site	spaceflight.rocket_launch_site.missions_launched_here
sports.pro_sports_played.sport	sports.sport.pro_athletes
sports.sports_league_participation.team	sports.sports_team.league
transportation.road_junction.road1	transportation.road.major_junctions1
tv.tv_rating_system.tv_ratings	tv.tv_rating.tv_rating_system
tv.tv_series_episode.series	tv.tv_program.episodes
award.ranked_list_compiler.ranked_lists	award.ranked_list.ranked_by
biology.genome.gene	biology.gene.genome
biology.organism_classification_placement.taxonomic_authority	biology.taxonomic_authority.taxonomic_placement
music.track_contribution.track	music.recording.contributions
people.appointment.appointed_role	people.appointed_role.appointment
protected_sites.natural_or_cultural_site_designation.listing_agency	protected_sites.natural_or_cultural_preservation_agency.natural_or_cultural_listings_maintained
royalty.chivalric_office.order	royalty.order_of_chivalry.office
royalty.noble_rank.titles_conferring_this_rank	royalty.noble_title.noble_rank
soccer.football_match.held_at	soccer.football_pitch.matches
theater.play.genre	theater.theater_genre.plays_in_this_genre
boxing.match_boxer_relationship.match	boxing.boxing_match.fighters
digicams.digital_camera.image_stabilization_capability	digicams.camera_image_stabilization.digital_camera
food.wine_style.grape_varieties	wine.grape_variety.wine_styles
government.general_election.includes_general_elections	government.general_election.part_of_general_election
opera.opera.librettist	opera.librettist.libretti
organization.organization_membership.organization	organization.membership_organization.members
book.book_edition_series.editions_in_this_series	book.book_edition.book_edition_series
business.brand.colors	business.brand_colors.brand
cvg.computer_videogame.gameplay_modes	cvg.gameplay_mode.games_with_this_mode
film.film.film_casting_director	film.film_casting_director.films_casting_directed
food.beer_style.bjcp_style_category	food.beer_style_category.styles
interests.collector.collections	interests.collection.collector
music.recording_contribution.album	music.album.contributor
award.recurring_award_ceremony.awards	award.award.ceremony
event.speech_or_presentation.presented_work	event.presented_work.performances
food.cheese.certification	food.cheese_certification.certified_cheeses
government.government.agency	government.government_agency.government
language.language_creator.languages_created	language.conlang.created_by
measurement_unit.measurement_system.volume_units	measurement_unit.volume_unit.measurement_system
music.music_video.directed_by	music.music_video_director.music_videos_directed
opera.opera_designer_gig.opera	opera.opera_production.designers
symbols.armorial_grant.armiger	symbols.coat_of_arms_bearer.coat_of_arms_used
theater.theater_production_venue_relationship.theater	theater.theater.theater_production_venue_relationship
automotive.model_year.previous_model_year	automotive.model_year.next_model_year
award.ranked_item.appears_in_ranked_lists	award.ranking.item
boats.ship.ship_class	boats.ship_class.ships_in_class
celebrities.sexual_orientation_phase.celebrity	celebrities.celebrity.sexual_orientation
dataworld.provenance.source	dataworld.information_source.authority
film.film.release_date_s	film.film_regional_release_date.film
geography.mountain.mountain_type	geography.mountain_type.mountains_of_this_type
government.governmental_jurisdiction.official_symbols	location.location_symbol_relationship.administrative_division
radio.radio_program.subjects	radio.radio_subject.programs_with_this_subject
spaceflight.satellite.launch_vehicle	spaceflight.rocket.satellites_launched
sports.sports_team_coach_tenure.team	sports.sports_team.coaches
visual_art.art_series.artist	visual_art.visual_artist.art_series
award.ranked_list.ranked_list_items	award.ranking.list
book.illustrator.magazine_issues_illustrated	book.magazine_issue.interior_illustrations_by
film.film.film_production_design_by	film.film_production_designer.films_production_designed
visual_art.artwork.edition_of	visual_art.artwork.editions
wine.wine.fruit_source	wine.fruit_source.wines
zoos.animal_captivity.exhibit	zoos.zoo_exhibit.notable_animals
amusement_parks.roller_coaster.propulsion	amusement_parks.roller_coaster_propulsion_system.roller_coasters
biology.gene.chromosome	biology.chromosome.gene
computer.programming_language.language_designers	computer.programming_language_designer.languages_designed
location.cn_autonomous_county.designated_minority	people.chinese_ethnic_group.autonomous_counties
music.album.featured_artists	music.featured_artist.albums
skiing.lift_tenure.manufacturer	skiing.ski_lift_manufacturer.ski_lifts
automotive.trim_level.option_packages	automotive.option_package.trim_levels
chemistry.isotope.decay_modes	chemistry.isotope_decay.isotope
engineering.battery_size.cell_variations	engineering.battery_size_cell_variation.size
influence.influence_node.influenced_by	influence.influence_node.influenced
measurement_unit.magnetic_flux_density_unit.measurement_system	measurement_unit.measurement_system.magnetic_flux_density_units
medicine.medical_treatment.trials	medicine.medical_trial.treatment_being_tested
metropolitan_transit.transit_line.stops	metropolitan_transit.transit_stop.transit_lines
royalty.noble_rank.opposite_gender_equivalent	royalty.noble_rank_gender_equivalence.noble_rank
royalty.noble_title.holders	royalty.noble_title_tenure.noble_title
tv.regular_tv_appearance.character	tv.tv_character.appeared_in_tv_program
aviation.airline_alliance.member_airlines	aviation.airline.alliance
book.periodical_publisher_period.periodical	book.periodical.publisher
cvg.game_performance.character	cvg.game_character.games
cvg.game_version.platform	cvg.cvg_platform.games_on_this_platform
education.educational_institution.sports_teams	sports.school_sports_team.school
music.concert.concert_recording	music.live_album.concert
music.concert.set_list	music.concert_set_list.concert
religion.religious_organization_leadership.role	religion.religious_leadership_title.leaders
sports.sports_team.arena_stadium	sports.sports_facility.teams
astronomy.galactic_interaction.status	astronomy.galactic_interaction_status.galactic_interactions
award.award_honor.award	award.award_category.winners
business.defunct_company.reason_for_ceasing_operations	business.company_termination_type.companies
fictional_universe.fictional_organization.fictional_organization_founder	fictional_universe.fictional_organization_founder.fictional_organizations_founded
film.film.genre	film.film_genre.films_in_this_genre
measurement_unit.unit_of_volumetric_flow_rate.measurement_system	measurement_unit.measurement_system.volumetric_flow_rate_units
medicine.disease.prevention_factors	medicine.condition_prevention_factors.conditions_this_may_prevent
military.force_strength.combatant	military.military_combatant.force_deployments
religion.religion.organizations	religion.religious_organization.associated_with
theater.theater_character.plays_appears_in	theater.play.characters
amusement_parks.disney_ride.ticket	amusement_parks.disney_ride_ticket_membership.ride
book.author.contributing_author_to	book.book_edition.contributing_authors
business.company_brand_relationship.company	business.consumer_company.brands
comic_strips.comic_strip_character.comic_strips_appeared_in	comic_strips.comic_strip.characters
computer.computer_peripheral_class.instances	computer.computer_peripheral_class.instance_of
computer.file_format.container_for	computer.file_format.contained_by
education.educational_institution.radio_station	education.student_radio_station.school
law.us_patent.associated_inventions	law.invention.patents
opera.opera_production_staff_gig.production_role	opera.opera_production_staff_role.production_staff
tv.tv_segment_guest_appearance.person	tv.tv_program_guest.segment_appearances
american_football.football_team.current_head_coach	american_football.football_coach.current_team_head_coached
automotive.generation.successor	automotive.generation.predecessor
chemistry.chemical_element.isotopes	chemistry.isotope.isotope_of
comic_strips.comic_strip.genre	comic_strips.comic_strip_genre.comic_strips_of_this_genre
geography.mountain.listings	geography.mountain_listing.mountains
measurement_unit.measurement_system.area_units	measurement_unit.area_unit.measurement_system
music.album.artist	music.artist.album
olympics.olympic_athlete_affiliation.sport	olympics.olympic_sport.athletes
astronomy.meteor_shower.source_of_meteor_shower	astronomy.comet.meteor_shower_spawned
automotive.model_year.body_style	automotive.body_style.examples
award.competition.competitors	award.competitor.competitions
cvg.computer_videogame.platforms	cvg.cvg_platform.games
film.film_crewmember.films_crewed	film.film_crew_gig.crewmember
geography.lake.lake_type	geography.lake_type.lakes_of_this_type
internet.top_level_domain.domain_type	internet.top_level_domain_type.domains
internet.website_ownership.website	internet.website.owner_new
location.metropolitan_area.category	location.metropolitan_area_category.metro_areas
olympics.olympic_sport.games_contested_as_demonstration	olympics.olympic_games.demonstration_sports
protected_sites.natural_or_cultural_site_listing.listed_site	protected_sites.listed_site.designation_as_natural_or_cultural_site
royalty.order_of_chivalry.chivalric_titles	royalty.chivalric_title.order_of_chivalry
wine.grape_variety_composition.grape_variety	wine.grape_variety.wines
boxing.boxing_title.organization	boxing.boxing_sanctioning_body.titles
chemistry.chemical_compound.phase_at_stp	chemistry.phase_of_matter.compounds_in_this_phase_at_stp
chemistry.chemical_series.elements	chemistry.chemical_element.chemical_series
fashion.designer_label_association.designer	fashion.fashion_designer.labels
film.film.film_collections	film.film_collection.films_in_collection
film.film_festival.sponsoring_organization	film.film_festival_sponsorship.festival
geography.island.body_of_water	geography.body_of_water.islands
government.government_position_held.legislative_sessions	government.legislative_session.members
interests.collection_category.items_in_this_category	interests.collectable_item.collection_category
law.court_courthouse_relationship.court	law.court.courthouse
measurement_unit.inductance_unit.measurement_system	measurement_unit.measurement_system.inductance_units
measurement_unit.permeability_unit.measurement_system	measurement_unit.measurement_system.permeability_units
organization.organization_committee.members	organization.organization_committee_membership.committee
soccer.football_disciplinary_action.punishment	soccer.football_disciplinary_punishment.player
computer.computer_emulator.peripherals	computer.computer_peripheral.emulators
distilled_spirits.distilled_spirit.aging	distilled_spirits.spirit_aging.spirit
engineering.battery.cell_type	engineering.battery_cell_type.batteries
film.film.film_art_direction_by	film.film_art_director.films_art_directed
ice_hockey.hockey_division.conference	ice_hockey.hockey_conference.divisions
soccer.football_player_loan.lending_team	soccer.football_team.loaned_players
spaceflight.space_mission.destination	spaceflight.mission_destination.missions_sent_here
sports.sports_championship_event.champion	sports.sports_team.championships
book.interview.interviewer	book.interviewer.interviews_conducted
book.written_work.subjects	book.book_subject.works
broadcast.content.advisory	broadcast.advisory.content
distilled_spirits.distilled_spirit.spirit_type	distilled_spirits.distilled_spirit_type.spirits
film.film.executive_produced_by	film.producer.films_executive_produced
government.government_service.operating_organization	organization.organization.operates_government_service
language.human_language.countries_spoken_in	location.country.languages_spoken
olympics.olympic_games.venues	olympics.olympic_venue.olympic_games_used_in
tv.regular_tv_appearance.series	tv.tv_program.regular_cast
tv.tv_crew_gig.tv_crew_role	tv.tv_crew_role.tv_episodes
architecture.occupancy.occupant	architecture.building_occupant.buildings_occupied
comic_books.comic_book_story.additional_plotting	comic_books.comic_book_writer.additional_plotting_contributions
cricket.cricket_umpire_panel_membership.umpire	cricket.cricket_umpire.accreditions
event.disaster.structures_damaged	event.disaster_affected_structure.damaged_by_disasters
location.adjoining_relationship.adjoins	location.location.adjoin_s
location.country.form_of_government	government.form_of_government.countries
metropolitan_transit.transit_line.terminuses	metropolitan_transit.transit_stop.terminus_for_lines
sports.tournament_event_competition.tournament	sports.multi_event_tournament.competitions
astronomy.galaxy.satellite_galaxies	astronomy.satellite_galaxy.satellite_of_this_galaxy
basketball.basketball_team.head_coach	basketball.basketball_coach.team
law.courthouse.courts_sitting_here	law.court_courthouse_relationship.courthouse
spaceflight.rocket.manufacturer	spaceflight.rocket_manufacturer.rockets_manufactured
tv.tv_network.channels	broadcast.tv_channel.network
aviation.airport_runway.surface	aviation.airport_runway_surface.runways
basketball.basketball_player_stats.player	basketball.basketball_player.player_statistics
comic_books.comic_book_series.continues	comic_books.comic_book_series.continued_by
fashion.textile.weave	fashion.weave.textiles_of_this_weave
food.wine_style.wines	wine.wine.wine_style
geography.glacier.status	geography.glacier_status.glaciers_of_this_status
influence.peer_relationship.peers	influence.influence_node.peers
people.appointment.appointee	people.appointee.position
physics.particle.interactions	physics.fundamental_interaction.particles
travel.accommodation.price_range	travel.accommodation_price_range.accommodation_in_this_range
biology.hybrid_parentage.parent	biology.hybrid_parent_classification.hybrids
celebrities.rehab.celebrity	celebrities.celebrity.rehab_history
government.government.government_for	government.governmental_jurisdiction.government
music.producer.releases_produced	music.release.producers
people.ethnicity.people	people.person.ethnicity
spaceflight.satellite_orbit_asynchronous.orbit_type	spaceflight.satellite_orbit_type.asynchronous_satellites
theater.theater_production.play	theater.play.productions
theater.theater_role.actor	theater.theater_actor.theater_roles
geography.mountain_range.passes	geography.mountain_pass.range
royalty.order_of_chivalry.lower_order	royalty.chivalric_order_relationship.higher_order
book.excerpted_work.excerpts	book.excerpt.work_excerpted
book.school_or_movement.associated_works	book.written_work.school_or_movement
comic_books.comic_book_creator.series_created	comic_books.comic_book_series.created_by
digicams.digital_camera.manufacturer	digicams.digital_camera_manufacturer.cameras
film.film.edited_by	film.editor.film
measurement_unit.radiant_intensity_unit.measurement_system	measurement_unit.measurement_system.radiant_intensity_units
medicine.drug.route_of_administration	medicine.drug_administration_route.administered_drugs
music.artist.label	music.record_label.artist
music.group_member.vocal_range	music.voice.singers
olympics.olympic_medal_demonstration.medal_winners	olympics.olympic_demonstration_medal_honor.medal
organization.club.areas_of_interest	organization.club_interest.clubs
organization.leadership.organization	organization.organization.leadership
sports.competitor_competition_relationship.team	sports.tournament_team.tournaments_competed_in
architecture.landscape_architect.landscape_project	architecture.landscape_project.landscape_architect
government.government_service.eligible_audience	government.government_service_audience.service_eligible_for
law.judicial_tenure.title	law.judicial_title.judges
location.country.third_level_divisions	location.administrative_division.third_level_division_of
music.group_member.instruments_played	music.instrument.instrumentalists
business.product_theme.product_lines	business.product_line.themes
music.multipart_release.components	music.release_component.package
olympics.olympic_medal_honor.medal	olympics.olympic_medal.medal_winners
royalty.system_of_nobility.titles	royalty.system_title_relationship.system
soccer.football_player.transfers	soccer.football_player_transfer.player
tv.regular_tv_appearance.actor	tv.tv_actor.starring_roles
education.educational_institution.school_type	education.school_category.schools_of_this_kind
measurement_unit.specific_volume_unit.measurement_system	measurement_unit.measurement_system.specific_volume_units
medicine.drug_formulation.strength	medicine.drug_strength.drug_formulations
music.recording.tracks	music.release_track.recording
royalty.chivalric_rank_precedence.order_of_chivalry	royalty.order_of_chivalry.chivalric_rank
royalty.chivalric_title.rank	royalty.chivalric_rank.titles_conferring_this_rank
skiing.ski_area.owner	skiing.ski_area_ownership.ski_area
sports.competitor_competition_relationship.country	sports.sport_country.athletic_performances
tv.tv_series_episode.previous_episode	tv.tv_series_episode.next_episode
visual_art.artwork.art_form	visual_art.visual_art_form.artworks
astronomy.star.constellation	astronomy.constellation.contains
celebrities.substance_abuse_problem.celebrity	celebrities.celebrity.substance_abuse_problems
measurement_unit.substance_unit.measurement_system	measurement_unit.measurement_system.substance_units
people.american_indian_group.us_indian_reservations	location.us_indian_reservation.tribes
amusement_parks.ride.ride_type	amusement_parks.ride_type.rides
astronomy.astronomical_discovery.status	astronomy.astronomical_discovery_status.objects
film.film.production_companies	film.production_company.films
internet.website.category	internet.website_category.sites
people.appointment.appointed_by	people.appointer.appointment_made
travel.hotel.operating_brand	travel.hotel_brand.hotels_in_this_brand
tv.tv_regular_personal_appearance.person	tv.tv_personality.tv_regular_appearances
astronomy.telescope.housed_in	astronomy.astronomical_observatory.telescope_s
automotive.make.model_s	automotive.model.make
business.issue.type_of_issue	business.issue_type.issues_of_this_type
digicams.digital_camera.format	digicams.camera_format.cameras
film.film_series.films_in_series	film.film.film_series
measurement_unit.dose_equivalence_unit.measurement_system	measurement_unit.measurement_system.dose_equivalence_units
military.casualties.military_conflict	military.military_conflict.casualties
military.military_command.military_conflict	military.military_conflict.commanders
physics.particle.generation	physics.subatomic_particle_generation.particles
book.newspaper.circulation_areas	periodicals.newspaper_circulation_area.newspapers
comedy.comedian.genres	comedy.comedy_genre.comedians
dining.chef.cuisines	dining.cuisine.chefs
distilled_spirits.distilled_spirit.bottler	distilled_spirits.spirit_bottler.spirits_bottled
engineering.piston_engine.fuel_delivery_method	engineering.fuel_delivery_method.engines
finance.exchange_rate.source_of_exchange	finance.currency.source_of_exchange
location.capital_of_administrative_division.capital_of	location.administrative_division_capital_relationship.capital
location.country.fourth_level_divisions	location.administrative_division.fourth_level_division_of
media_common.completer_of_unfinished_work.completed_unfinished_works	media_common.completion_of_unfinished_work.finisher
music.single.versions	music.recording.canonical_version
organization.organization.legal_structure	business.company_type.companies_of_this_type
spaceflight.rocket.status	spaceflight.rocket_status.rockets
sports.multi_event_tournament.competitors	sports.competitor_country_relationship.tournament
sports.sports_championship_event.season	sports.sports_league_season.championship
sports.sports_official.sport	sports.sport.officials
sports.sports_team_roster.position	sports.sports_position.players
tv.tv_producer_episode_credit.episode	tv.tv_series_episode.producers
book.serial_installment.serialized_work	book.serialized_work.serial_installments
computer.file_format.used_on	computer.computing_platform.file_formats_supported
cricket.cricket_series.series_events	cricket.cricket_series_event.series
fictional_universe.fictional_calendar_system.replaced_with	fictional_universe.fictional_calendar_system.preceded_by
fictional_universe.fictional_universe.locations	fictional_universe.fictional_setting.universe
music.concert_performance.artist	music.artist.concerts
theater.theater_production.soundtracks	theater.musical_soundtrack.production
travel.hotel.grade	travel.hotel_grade.hotel
american_football.football_historical_coach_position.position	american_football.football_coach_position.coaches_holding_this_position
amusement_parks.ride.theme	amusement_parks.ride_theme.rides
book.contents.work	book.published_work.published_in_published_as
comic_books.comic_book_story.part_of_story_arc	comic_books.comic_book_story_arc.spanning
film.film_film_company_relationship.film	film.film.other_film_companies
measurement_unit.unit_of_frequency.measurement_system	measurement_unit.measurement_system.frequency_units
music.recording.engineer	music.engineer.tracks_engineered
people.measured_person.sizes	fashion.clothing_size.person
digicams.digital_camera.image_ratio	digicams.camera_image_ratio.cameras
finance.exchange_rate.target_of_exchange	finance.currency.target_of_exchange
government.election_poll.subject	government.election_poll_score.poll
olympics.olympic_athlete_affiliation.country	olympics.olympic_participating_country.athletes
olympics.olympic_event_competition.event	olympics.olympic_event.competitions
people.canadian_aboriginal_group.canadian_indian_reserves	location.ca_indian_reserve.aboriginal_groups
spaceflight.satellite_orbit_synchronous.orbit_type	spaceflight.satellite_orbit_type.synchronous_satellites
sports.tournament_event_competition.event	sports.tournament_event.competitions
venture_capital.venture_investment.investment_round	venture_capital.investment_round.venture_investments
education.honorary_degree.institution	education.educational_institution.honorary_degrees_awarded
location.cn_autonomous_region.designated_minority	people.chinese_ethnic_group.autonomous_regions
measurement_unit.viscosity_unit.measurement_system	measurement_unit.measurement_system.viscosity_units
organization.organization.locations	business.business_location.parent_company
royalty.chivalric_order_membership.recipient	royalty.chivalric_order_member.belongs_to_order
sports.multi_event_tournament.athletic_performances	sports.competitor_competition_relationship.tournament
sports.pro_athlete.sports_played_professionally	sports.pro_sports_played.athlete
travel.travel_destination.how_to_get_here	travel.transportation.travel_destination
tv.tv_producer_term.program	tv.tv_program.tv_producer
automotive.privately_owned_vehicle.model_year	automotive.model_year.examples
book.translator.works_translated	book.translation.translator
broadcast.content.artist	broadcast.artist.content
chemistry.chemical_classification.higher_classifications	chemistry.chemical_classification.lower_classifications
media_common.dedication.work_dedicated	media_common.dedicated_work.dedication
music.group_membership.group	music.musical_group.member
soccer.football_league_participation.league	soccer.football_league.teams
sports.sports_team.sport	sports.sport.teams
celebrities.rivalry.rival	celebrities.celebrity.celebrity_rivals
computer.operating_system.developer	computer.operating_system_developer.operating_systems_developed
medicine.manufactured_drug_form.therapeutic_equivalents	medicine.drug_therapeutic_equivalence_relationship.equivalent
tv.tv_episode_segment.performances	tv.tv_segment_performance.segment
amusement_parks.roller_coaster.train_configuration	amusement_parks.roller_coaster_train_configuration.roller_coasters
distilled_spirits.blended_spirit.components	distilled_spirits.distilled_spirit_type.blends
government.election_campaign.election	government.election.campaigns
law.court.jurisdiction	law.court_jurisdiction_area.courts
rail.railway.terminuses	rail.railway_terminus.railways_terminating_here
business.shopping_center.store	business.business_location.in_shopping_center
cricket.cricket_coach.overall_test_stats	cricket.cricket_team_stats.test_coach
event.public_speaking_event.speech_presentation_discussion	event.speech_or_presentation.event
film.film_film_distributor_relationship.distributor	film.film_distributor.films_distributed
finance.currency.countries_formerly_used	location.country.currency_formerly_used
food.beer_containment.container_type	food.beer_container.beers
martial_arts.martial_artist.martial_art	martial_arts.martial_art.well_known_practitioner
music.recording.producer	music.producer.tracks_produced
opera.opera.recordings	opera.opera_recording.opera
religion.religious_leadership_jurisdiction_appointment.title	religion.religious_leadership_title.jurisdictions
royalty.system_order_relationship.system	royalty.system_of_nobility.orders_of_chivalry
spaceflight.bipropellant_rocket_engine.engine_cycle	spaceflight.rocket_engine_cycle.rocket_engines
time.holiday.day_of_year	time.day_of_year.holidays
automotive.trim_level.model_year	automotive.model_year.trim_levels
distilled_spirits.spirit_blender.blends	distilled_spirits.blended_spirit.blender
internet.website.api	internet.api.site
language.language_family.languages	language.human_language.language_family
music.composition.includes	music.composition.part_of
olympics.olympic_medal_honor.country	olympics.olympic_participating_country.medals_won
olympics.olympic_medal_honor.medalist	olympics.olympic_athlete.medals_won
aviation.aircraft_ownership_count.aircraft_model	aviation.aircraft_model.number_owned_by
biology.organism_classification.rank	biology.organism_classification_rank.organism_classifications
broadcast.radio_station_owner.radio_stations	broadcast.radio_station.owner
comic_strips.comic_strip_creator_duration.creator_of_strip	comic_strips.comic_strip_creator.comic_strips_written
digicams.digital_camera.iso_setting	digicams.camera_iso.cameras
fictional_universe.marriage_of_fictional_characters.spouses	fictional_universe.fictional_character.married_to
measurement_unit.potential_unit.measurement_system	measurement_unit.measurement_system.potential_units
projects.project_participation.role	projects.project_role.projects
sports.sports_league_season.league	sports.sports_league.seasons
tv.tv_guest_role.actor	tv.tv_actor.guest_roles
visual_art.art_subject.artwork_on_the_subject	visual_art.artwork.art_subject
visual_art.visual_artist.art_forms	visual_art.visual_art_form.artists
astronomy.telescope.type_of_telescope	astronomy.telescope_type.telescopes_of_this_type
book.newspaper_issue.newspaper	book.newspaper.issues
computer.computer.manufacturer	computer.computer_manufacturer_brand.computer_models
food.beer_containment.beer	food.beer.containers
law.us_patent.us_classification_category	law.us_patent_category.patents
location.location.contains_major_portion_of	location.location.primarily_containedby
measurement_unit.radiance_unit.measurement_system	measurement_unit.measurement_system.radiance_units
media_common.media_genre.parent_genre	media_common.media_genre.child_genres
medicine.manufactured_drug_form.flavor	medicine.drug_dosage_flavor.drugs_with_this_flavor
religion.religious_organization_leadership.leader	religion.religious_leader.religious_leadership
biology.plant_disease_triangle.plant_disease_conditions	biology.plant_disease_conditions.plant_disease_triangle
book.magazine.genre	book.magazine_genre.magazines_in_this_genre
book.translated_work.translations	book.translation.translation_of
boxing.boxing_title_tenure.champion	sports.boxer.titles
comic_books.comic_book_series.issues	comic_books.comic_book_issue.part_of_series
cricket.cricket_bowler.odi_bowling_stats	cricket.cricket_bowler_stats.odi_bowler
cvg.computer_game_rating_system.content_descriptors	cvg.computer_game_content_descriptor.rating_system
fictional_universe.fictional_character.based_on	fictional_universe.person_in_fiction.representations_in_fiction
interests.collection.category	interests.collection_category.collectors
martial_arts.martial_arts_certification.qualification	martial_arts.martial_arts_qualification.martial_artists
medicine.drug.pregnancy_category	medicine.drug_pregnancy_category.drugs_in_this_category
organization.organization_relationship.parent	organization.organization.child
people.cause_of_death.includes_causes_of_death	people.cause_of_death.parent_cause_of_death
spaceflight.rocket.rocket_function	spaceflight.rocket_function.rockets_supporting_this_function
sports.sports_league_participation.league	sports.sports_league.teams
tv.tv_genre.programs	tv.tv_program.genre
tv.tv_location.tv_segments_filmed_here	tv.tv_episode_segment.filming_locations
venture_capital.venture_investment.investor	venture_capital.venture_investor.investments
wine.wine.region	wine.wine_region.wines
architecture.structure.contractor	architecture.architectural_contractor.projects
book.contents.publication	book.publication.contents
broadcast.radio_station.format	broadcast.radio_format.stations
government.primary_election.follow_on_election	government.election.primaries
olympics.olympic_medal_honor.event	olympics.olympic_event_competition.medalists
people.ethnicity.included_in_group	people.ethnicity.includes_groups
amusement_parks.amusement_park_area.parks	amusement_parks.park.areas
business.product_with_ingredients.ingredients	business.product_ingredient.used_in_products
education.department.academics_old	education.academic.departments_old
film.film.costume_design_by	film.film_costumer_designer.costume_design_for_film
location.us_county.hud_section_8_area	location.hud_section_8_area.county
soccer.football_player_stats.player	soccer.football_player.statistics
astronomy.astronomical_discovery.discoverer	astronomy.astronomer.astronomical_objects_discovered
business.business_operation.industry	business.industry.companies
cvg.computer_game_engine.predecessor_engine	cvg.computer_game_engine.successor_engine
internet.api.protocols	internet.protocol.api
measurement_unit.inverse_temperature_unit.measurement_system	measurement_unit.measurement_system.inverse_temperature_units
opera.opera_production.producer	opera.opera_producer.operas_produced
astronomy.type_of_planetographic_feature.includes	astronomy.type_of_planetographic_feature.included_in
boats.ship.ship_builder	boats.ship_builder.ships_built
cvg.computer_videogame.game_series	cvg.game_series.games_in_series
education.education.degree	education.educational_degree.people_with_this_degree
fictional_universe.school_in_fiction.students_graduates	fictional_universe.fictional_character.education
food.recipe.ingredients	food.recipe_ingredient.recipe
medicine.disease_cause.diseases	medicine.disease.causes
royalty.precedence.lower_rank	royalty.noble_rank.higher_rank
symbols.coat_of_arms.variation_of_the_field	symbols.heraldic_variation_of_the_field_color.coat_of_arms
astronomy.astronomical_discovery.discovery_organization	astronomy.astronomical_survey_project_organization.celestial_objects_discovered
biology.owned_animal.owners	biology.animal_ownership.animal
book.book.characters	book.book_character.appears_in_book
ice_hockey.hockey_team.division	ice_hockey.hockey_division.teams
medicine.icd_9_cm_classification.includes_classifications	medicine.icd_9_cm_classification.parent_classification
soccer.football_player_loan.player	soccer.football_player.loans
soccer.football_team_manager.matches	soccer.football_team_manager_match_participation.manager
tv.tv_actor.tv_segment_performances	tv.tv_segment_performance.actor
comic_books.comic_book_story.characters	comic_books.comic_book_character.story_specific_appearances
comic_books.comic_book_story.inks	comic_books.comic_book_inker.comic_books_inked
medicine.infectious_disease.infectious_agent_type	medicine.type_of_infectious_agent.diseases
military.military_combatant.armed_forces	military.armed_force.military_combatant
religion.religion.founding_figures	religion.founding_figure.religion_founded
symbols.coat_of_arms.crest	symbols.heraldic_crest.coat_of_arms
symbols.heraldic_charge_color.charge	symbols.heraldic_charge.coat_of_arms
tv.tv_episode_segment.songs	tv.tv_segment_song_relationship.segment
boats.ship_ownership.owner	boats.ship_owner.ships_owned
digicams.digital_camera.uncompressed_formats	digicams.camera_uncompressed_format.cameras
fictional_universe.fictional_object.destruction_method	fictional_universe.fictional_object_destruction_method.fictional_objects_destroyed
fictional_universe.fictional_setting.contained_by	fictional_universe.fictional_setting.contains
film.film_film_distributor_relationship.film_distribution_medium	film.film_distribution_medium.films_distributed_in_this_medium
music.recording_contribution.contributor	music.artist.contribution
zoos.animal_captivity.animal	zoos.zoo_animal.zoos
biology.plant_disease_triangle.plant_disease_cause	biology.plant_disease_cause.plant_disease_triangle
biology.source_organism.usable_parts	biology.organism_part.from_organism
digicams.digital_camera.sensor_type	digicams.camera_sensor_type.digital_cameras
location.cn_autonomous_prefecture.designated_minority	people.chinese_ethnic_group.autonomous_prefectures
music.music_video.music_video_genre	music.music_video_genre.music_videos_of_this_genre
organization.non_profit_designation.organizations_with_this_designation	organization.non_profit_registration.registered_as
spaceflight.rocket_engine.status	spaceflight.rocket_engine_status.rocket_engines
sports.competitor_competition_relationship.medal	sports.sport_medal.medal_winners
sports.sports_team_coach_tenure.coach	sports.sports_team_coach.teams_coached
astronomy.galactic_super_cluster.galaxy_filament	astronomy.galactic_filament.galaxy_superclusters
book.periodical.editorial_staff	book.editorial_tenure.periodical
business.product_endorsement.endorser	business.product_endorser.products_endorsed
comic_books.comic_book_issue.cover_colors	comic_books.comic_book_colorist.comic_covers_colored
religion.religion.deities	religion.deity.deity_of
religion.religion.includes	religion.religion.is_part_of
aviation.aviation_waypoint.waypoint_type	aviation.waypoint_type.waypoints_of_this_type
award.award_achievement_level.award	award.award.achievement_levels
book.report_issuing_institution.technical_reports_issued	book.technical_report.institution
education.academic.advisors	education.academic.advisees
exhibitions.exhibition.exhibition_types	exhibitions.type_of_exhibition.exhibitions_of_this_type
government.government_issued_permit.permit_type	government.government_permit_type.permit
government.government_service.government_service_channel	government.government_service_channel.government_service
measurement_unit.measurement_system.temperature_units	measurement_unit.temperature_unit.measurement_system
meteorology.forecast_zone.weather_service	meteorology.meteorological_service.forecast_zones
music.track_contribution.role	music.performance_role.track_performances
people.profession.part_of_professional_field	people.professional_field.professions_in_this_field
sports.sports_team.captains	sports.sports_team_captain_tenure.team
symbols.heraldic_ordinaire_color.ordinaire	symbols.heraldic_ordinaire.coat_of_arms
biology.organism.parents	biology.organism.children
computer.programming_language.developers	computer.programming_language_developer.programming_languages_developed
measurement_unit.wavenumber_unit.measurement_system	measurement_unit.measurement_system.wavenumber_units
people.marriage.spouse	people.person.spouse_s
sports.sports_team_coach_tenure.position	sports.coaching_position.coaches
american_football.football_team.division	american_football.football_division.teams
astronomy.meteorite.meteorite_composition	astronomy.meteoric_composition.meteorites
award.award_honor.honored_for	award.award_winning_work.awards_won
award.competition.instance_of_recurring_competition	award.recurring_competition.individual_competitions
chess.chess_game_participation.player	chess.chess_player.games_played
education.school_district.schools	education.school.school_district
fictional_universe.fictional_character.organizations	fictional_universe.fictional_organization.members
film.film_song_relationship.performers	film.film_song_performer.film_songs
internet.website.owner	internet.website_owner.websites_owned
measurement_unit.radioactivity_unit.measurement_system	measurement_unit.measurement_system.radioactivity_units
metropolitan_transit.transit_system.transit_service_types	metropolitan_transit.transit_service_type.transit_systems
theater.theater_designer_gig.design_role	theater.theater_designer_role.designers
architecture.architecture_firm.firm_partners	architecture.architecture_firm_partners.partner_in_firm
measurement_unit.charge_unit.measurement_system	measurement_unit.measurement_system.charge_units
measurement_unit.measurement_system.power_units	measurement_unit.power_unit.measurement_system
measurement_unit.unit_of_specific_fuel_consumption.measurement_system	measurement_unit.measurement_system.specific_fuel_consumption_units
metropolitan_transit.transit_line.service_type	metropolitan_transit.transit_service_type.transit_lines
olympics.olympic_demonstration_medal_honor.olympics	olympics.olympic_games.demonstration_medals_awarded
organization.organization_board_membership.organization	organization.organization.board_members
theater.theater_production_staff_gig.production_role	theater.theater_production_staff_role.people_who_have_had_this_role
biology.organism.organism_type	biology.organism_classification.organisms_of_this_type
comic_strips.comic_strip_syndicate_duration.syndicate	comic_strips.comic_strip_syndicate.comic_strips_syndicated
distilled_spirits.distilled_spirit.distillery	distilled_spirits.distillery.spirits
distilled_spirits.distillery.region	distilled_spirits.spirit_producing_region.distilleries
fictional_universe.fictional_employment_tenure.employer	fictional_universe.fictional_employer.employees
food.ingredient.incompatible_with_dietary_restrictions	food.dietary_restriction.incompatible_ingredients
government.government_service_audience.eligible_jurisdiction	government.governmental_jurisdiction.contains_service_audience
language.human_language.dialects	language.language_dialect.language
music.group_membership.role	music.performance_role.regular_performances
sports.sports_championship.events	sports.sports_championship_event.championship
tv.tv_episode_segment.director	tv.tv_director.tv_segments_directed
aviation.aircraft.model	aviation.aircraft_model.aircraft
dining.chef.restaurants	dining.restaurant_chef_association.chef
measurement_unit.luminous_intensity_unit.measurement_system	measurement_unit.measurement_system.luminous_intensity_units
music.album.release_type	music.album_release_type.albums
symbols.name_source.namesakes	symbols.namesake.named_after
theater.theater_role.play	theater.theater_production.cast
visual_art.artwork.support	visual_art.visual_art_support.artworks
book.newspaper.owner	book.newspaper_owner.newspapers_owned
event.disaster.victims	event.disaster_victim.killed_in_disaster
measurement_unit.unit_of_surface_density.measurement_system	measurement_unit.measurement_system.surface_density_units
medicine.disease.notable_people_with_this_condition	medicine.notable_person_with_medical_condition.condition
rail.railway_type_relationship.railway_type	rail.railway_type.railways_of_this_type
architecture.architect.structures_designed	architecture.structure.architect
automotive.generation.platforms	automotive.platform.generations
book.literary_series.part_of_series	book.literary_series.sub_series
cricket.cricket_match.team_rosters	cricket.cricket_roster.roster_in_match
food.recipe_ingredient.ingredient	food.ingredient.recipes
military.military_service.rank	military.rank.used_by_services
theater.theater_designer_gig.play	theater.theater_production.designers
time.event.instance_of_recurring_event	time.recurring_event.instances
tv.tv_series_season.rating	tv.tv_rating.tv_seasons
astronomy.extraterrestrial_location.on_celestial_object	astronomy.celestial_object.locations
cricket.cricket_bowler.test_bowling_stats	cricket.cricket_bowler_stats.test_bowler
dataworld.data_tool.uses_tools	dataworld.data_tool.used_by_tool
food.ingredient.cuisine	dining.cuisine.ingredients
martial_arts.martial_art.category	martial_arts.martial_art_category.martial_arts
media_common.dedication.dedicated_by	media_common.dedicator.dedications
media_common.quotation.author	people.person.quotations
opera.opera_production.conductor	music.conductor.operas_conducted
royalty.monarch.royal_line	royalty.royal_line.monarchs_from_this_line
tv.tv_episode_segment.sequence	tv.sequence_of_tv_episode_segments.segments
astronomy.galaxy.interaction	astronomy.galactic_interaction.galaxy
automotive.trim_level.us_fuel_economy	automotive.us_fuel_economy.trim_level
award.hall_of_fame.inductees	award.hall_of_fame_induction.hall_of_fame
cvg.game_version.publisher	cvg.cvg_publisher.game_versions_published
dining.restaurant_chef_association.restaurant	dining.restaurant.chefs
exhibitions.exhibition_run.sponsor	exhibitions.exhibition_sponsor.exhibitions_sponsored
government.government_position_held.office_holder	government.politician.government_positions_held
organization.organization.geographic_scope	organization.organization_scope.organizations_with_this_scope
rail.locomotive_class_operator_relationship.railway_operator	rail.railway_operator.locomotive_classes
royalty.chivalric_order_membership.title	royalty.chivalric_title.title_holders
royalty.noble_title.opposite_gender_equivalent	royalty.noble_title_gender_equivalency.equivalent_title
theater.play.orchestrator	theater.theatrical_orchestrator.plays_orchestrated
